TransDate,TransactionDescription,Amount,Balance
04/04,"Deposit Home Banking Transfer REF# 58451743....................  From HODGES,JUSTINE B 532694 Share 10",100.00,"1,735.26"
04/05,Withdrawal Home Banking Transfer To Share 10....................  REF# 58457972,-200.00,"1,535.26"
04/06,Deposit Home Banking Transfer From Share 10......................  REF# 58489900,75.00,"1,610.26"
04/14,Deposit ACH UNIVERSITY OF CO............................................  TYPE: DIR DEP CO: UNIVERSITY OF CO,156.89,"1,767.15"
04/28,Deposit ACH UNIVERSITY OF CO............................................  TYPE: DIR DEP CO: UNIVERSITY OF CO DEP PRENOTIFICATION FROM UNIVERSITY OF CO,147.65,"1,914.80"
04/30,"Deposit Dividend 0.050%........................................................  Annual Percentage Yield Earned 0.050% for period: 04/01/23 to 04/30/23 Ending Balance............................................................................. 1,914.87 Equal Housing Opportunity Ent is a registered trademark of Ent Credit Union Insured by NCUA AccountNumber 1159412 StatementPeriod04/01/23thru04/30/23 Page 2 of 10 No Strings Checking - 10 NO STRINGS CHECKING Dividends Earned YTD: 0.01 JointOwner:TYMITCHELL Beginning Balance + Deposits & Other Credits (10) - Checks Cleared (0) - Withdrawals & Other Debits (107)= Ending Balance $1,114.39 $2,988.06 $0.00 $3,850.30 $252.15 TransDate EffDate TransactionDescription Amount Balance Beginning Balance......................................................................... 1,114.39",0.07,"1,914.87"
04/01,Withdrawal Debit Card Visa Check...........................................  JIMMY JOHNS - 2924 COLORADO SPRI CO 5814,-9.97,"1,104.42"
04/01,Withdrawal Debit Card Visa Check...........................................  AMZN Mktp US*HY0X86PQ2 Amzn.com/bill WA 5942,-33.79,"1,070.63"
04/01,Withdrawal Debit Card Visa Check...........................................  KUM&GO 0667R CO SPRIN CO SPRINGS CO 5542,-30.05,"1,040.58"
04/02,"04/01 Withdrawal Home Banking Transfer REF# 58361174..............  To HODGES,JUSTINE B 532694 Share 10",-15.00,"1,025.58"
04/02,Withdrawal Debit Card Visa Check...........................................  FUZZYS TACO SHOP COLORA TIMNATH CO 5812,-32.00,993.58
04/02,Withdrawal Debit Card Visa Check...........................................  PANDA EXPRESS #3558 FALCON CO 5814,-11.67,981.91
04/02,Withdrawal POS #309212425631...........................................  COSTCO WHSE #1030 COLORADO SPG CO 5300,-101.38,880.53
04/02,Withdrawal POS #309216843545...........................................  AUTOZONE 3434 690 W GA COLORADO SPRI CO 5533,-19.34,861.19
04/02,Withdrawal POS #309217088010...........................................  CIRCLE K 09847 COLORADO SPRN CO 5541,-6.23,854.96
04/03,Withdrawal POS #309312399643...........................................  CIRCLE K 09847 COLORADO SPRN CO 5541,-6.48,848.48
04/03,"Withdrawal Home Banking Transfer........................................  To HODGES,JUSTINE B 532694 Share 10 REF# 58405865 VILLA",-141.00,707.48
04/03,Recurring Withdrawal Debit Card Visa Check..........................  KING SOOPERS 5053 719-598-5177 CO 5411,-42.64,664.84
04/04,Withdrawal Debit Card Visa Check...........................................  McDonalds 4126 COLORADO SPRI CO 5814,-3.55,661.29
04/04,Withdrawal Debit Card Visa Check...........................................  AMZN Mktp US*HY0HZ7IM2 Amzn.com/bill WA 5942,-31.05,630.24
04/04,Withdrawal POS #309417696362...........................................  KUM&GO 0643R CO SPRINGS COLORADO SPRN CO 5541 Equal Housing Opportunity Ent is a registered trademark of Ent Credit Union Insured by NCUA AccountNumber 1159412 StatementPeriod04/01/23thru04/30/23 Page 3 of 10 1111111111111111111111010011001101110111001110011010100110000001010000001100010011000011101010101010000001111100001100010011000000011000101110000000101111000101010010100101010111000110000100000111010110100011111010011111110011100111001011011100010111011011010000111110111011001111111001001110110000010000010111111000000100000010110010001111010111011111101001001101001110000101101010101101000111111111110011001011000111010011110010001100000110100100001000001010110101010101010101010101 No Strings Checking - 10 NO STRINGS CHECKING (continued) TransDate EffDate TransactionDescription Amount Balance,-16.61,613.63
04/04,Deposit Home Banking Transfer From Share 13......................  REF# 58451489,56.00,669.63
04/04,Withdrawal Home Banking Transfer To Share 13....................  REF# 58451518,-150.00,519.63
04/05,Withdrawal Debit Card Visa Check...........................................  CIRCLE K 09847 COLORADO SPRI CO 5542,-56.56,463.07
04/05,Deposit Home Banking Transfer From Share 00......................  REF# 58457972,200.00,663.07
04/05,Withdrawal POS #309515406336...........................................  CIRCLE K # 40693 COLORADO SPRI CO 5541,-11.71,651.36
04/06,Withdrawal Debit Card Visa Check...........................................  CIRCLE K # 40693 COLORADO SPRI CO 5542,-90.09,561.27
04/06,"Deposit Home Banking Transfer REF# 58489879....................  From HODGES,JUSTINE B 532694 Share 10",789.45,"1,350.72"
04/06,"Withdrawal Home Banking Transfer REF# 58489890..............  To HODGES,JUSTINE B 532694 Share 01",-300.00,"1,050.72"
04/06,Withdrawal Home Banking Transfer To Share 12....................  REF# 58489894,-150.00,900.72
04/06,Withdrawal Home Banking Transfer To Share 13....................  REF# 58489897,-60.00,840.72
04/06,Withdrawal Home Banking Transfer To Share 00....................  REF# 58489900,-75.00,765.72
04/06,Withdrawal Debit Card Visa Check...........................................  DOMINOâ€™S 6259 COLORADO SPRI CO 5814,-29.19,736.53
04/06,Withdrawal Debit Card Visa Check...........................................  AMZN Mktp US*HS5EL53Y2 Amzn.com/bill WA 5942,-368.14,368.39
04/06,Withdrawal POS #309621292435...........................................  CIRCLE K # 40693 COLORADO SPRI CO 5541,-6.48,361.91
04/06,Withdrawal Debit Card Visa Check...........................................  UCCS DINING SERVICES COLORADO SPRI CO 8220,-7.88,354.03
04/06,Withdrawal Debit Card Visa Check...........................................  Equal Housing Opportunity Ent is a registered trademark of Ent Credit Union Insured by NCUA 379361-1.18-61933N11.no8 026847743 2-5 AccountNumber 1159412 StatementPeriod04/01/23thru04/30/23 Page 4 of 10 No Strings Checking - 10 NO STRINGS CHECKING (continued) TransDate EffDate TransactionDescription Amount Balance LEVELUPSMOOTHIEKING78 855-466-5585 MA 5812,-15.67,338.36
04/07,Withdrawal Debit Card Visa Check...........................................  ROADHOUSE CINEMAS - COL 520-661-4749 CO 7832,-30.06,308.30
04/07,Withdrawal POS #309717008966...........................................  COSTCO WHSE #1030 COLORADO SPG CO 5300,-124.89,183.41
04/07,Withdrawal Debit Card Visa Check...........................................  ALBERTACOS MEXICAN FOO COLORADO SPRI CO 5814,-17.10,166.31
04/07,Recurring Withdrawal #309726108602...................................  VASA FITNESS 800-748-4949 UT,-24.99,141.32
04/08,Deposit Home Banking Transfer From Share 12......................  REF# 58563927,140.00,281.32
04/08,Withdrawal POS #309814504519...........................................  KUM&GO 0667R CO SPRIN CO SPRINGS CO 5541,-6.23,275.09
04/08,Withdrawal Debit Card Visa Check...........................................  ROADHOUSE CINEMAS RAILY COLORADO SPRI CO 5812,-24.99,250.10
04/10,Withdrawal Debit Card Visa Check...........................................  094 TORCHYS COLORADO SP COLORADO SPRI CO 5812,-6.39,243.71
04/10,Recurring Withdrawal #310020719231...................................  ADOBE *CREATIVE CLOUD 408-536-6000 CA,-20.60,223.11
04/10,Withdrawal POS #310022539453...........................................  KUM&GO 0667R CO SPRIN CO SPRINGS CO 5541,-10.26,212.85
04/10,Withdrawal Debit Card Visa Check...........................................  LEVELUPSMOOTHIEKING91 855-466-5585 MA 5812,-17.84,195.01
04/11,Withdrawal #310122732298...................................................  8667127753 APPLE COM BILL CUPERTINO CA,-3.99,191.02
04/11,Recurring Withdrawal #310122734797...................................  8667127753 APPLE COM BILL CUPERTINO CA,-0.99,190.03
04/12,Withdrawal Debit Card Visa Check...........................................  STORE*CHICK-FIL-A WWW.DOORDASH. CA 5812,-21.41,168.62
04/12,Withdrawal Debit Card Visa Check...........................................  ALBERTACOS MEXICAN FOO COLORADO SPRI CO 5814,-12.75,155.87
04/13,Withdrawal Debit Card Visa Check...........................................  094 TORCHYS COLORADO SP COLORADO SPRI CO 5812,-6.61,149.26
04/13,Withdrawal Debit Card Visa Check...........................................  094 TORCHYS COLORADO SP COLORADO SPRI CO 5812,-6.46,142.80
04/14,Withdrawal Debit Card Visa Check...........................................  AMZN Mktp US*HJ1BH48K1 Amzn.com/bill WA 5942 Equal Housing Opportunity Ent is a registered trademark of Ent Credit Union Insured by NCUA AccountNumber 1159412 StatementPeriod04/01/23thru04/30/23 Page 5 of 10 1111111111111111111111010011001101110001001110011010100110000001010000001100010011000011101010101010000001100100001100010011000000111000101110000000011111000101010010100110110111000110000100111011010110100011111000011011110011100111010011101100010111011010101111111110111011011000001011011110110001100110011111111000010010110111110010101100001110110111101000011100000001000101101011010000011001111001100110001100110111011011010010111100100110100010001000101011010101010101010101010101 No Strings Checking - 10 NO STRINGS CHECKING (continued) TransDate EffDate TransactionDescription Amount Balance,-32.20,110.60
04/14,Deposit ACH UNIVERSITY OF CO............................................  TYPE: DIR DEP CO: UNIVERSITY OF CO,627.55,738.15
04/14,Withdrawal POS #310418461478...........................................  COSTCO WHSE #1030 COLORADO SPG CO 5300,-90.65,647.50
04/14,Recurring Withdrawal Debit Card Visa Check..........................  APPLE.COM/BILL 866-712-7753 CA 5818,-15.99,631.51
04/14,Withdrawal POS #310421350891...........................................  CIRCLE K 09847 COLORADO SPRN CO 5541,-4.79,626.72
04/15,Withdrawal Debit Card Visa Check...........................................  DP DOUGH COLORADO SPRIN COLORADO SPRI CO 5812,-16.31,610.41
04/15,Withdrawal Debit Card Visa Check...........................................  McDonalds 11078 COLORADO SPRI CO 5814,-3.55,606.86
04/16,Withdrawal Debit Card Visa Check...........................................  094 TORCHYS COLORADO SP COLORADO SPRI CO 5812,-6.52,600.34
04/16,Withdrawal Debit Card Visa Check...........................................  RAISING CANES 0392 COLORADO SPRI CO 5814,-22.70,577.64
04/17,Withdrawal POS #310712221538...........................................  CIRCLE K 09847 COLORADO SPRN CO 5541,-14.45,563.19
04/17,Withdrawal Debit Card Visa Check...........................................  APPLE.COM/BILL 866-712-7753 CA 5818,-2.99,560.20
04/17,Withdrawal Debit Card Visa Check...........................................  094 TORCHYS COLORADO SP COLORADO SPRI CO 5812,-23.94,536.26
04/17,Withdrawal POS #310720485178...........................................  CIRCLE K 09847 COLORADO SPRN CO 5541,-7.39,528.87
04/17,Withdrawal POS #310721177133...........................................  LOWEâ€™S #2578 COLORADO SPGS CO 5200,-6.99,521.88
04/18,Withdrawal Debit Card Visa Check...........................................  TARGET 00022210 COLORADO SPRI CO 5411,-42.74,479.14
04/18,Withdrawal Debit Card Visa Check...........................................  MCDONALDâ€™S F11078 COLORADO SPRI CO 5814,-9.29,469.85
04/18,Withdrawal Debit Card Visa Check...........................................  PANDA EXPRESS #687 COLORADO SPRI CO 5814,-19.15,450.70
04/18,Withdrawal Debit Card Visa Check...........................................  Equal Housing Opportunity Ent is a registered trademark of Ent Credit Union Insured by NCUA 379361-1.18-61933N11.no8 026847743 3-5 AccountNumber 1159412 StatementPeriod04/01/23thru04/30/23 Page 6 of 10 No Strings Checking - 10 NO STRINGS CHECKING (continued) TransDate EffDate TransactionDescription Amount Balance LOWES #00907* 866-483-7521 NC 5200,-7.55,443.15
04/18,Withdrawal Debit Card Visa Check...........................................  CHICK-FIL-A #02342 COLO SPGS CO 5814,-9.94,433.21
04/18,Withdrawal Debit Card Visa Check...........................................  PP*DUTCHBROSLL GRANTS PASS OR 5814,-6.16,427.05
04/19,Withdrawal Debit Card Visa Check...........................................  CIRCLE K 09847 COLORADO SPRI CO 5542,-54.48,372.57
04/19,Deposit ACH SUCCESS FOODS MA.........................................  TYPE: PAYROLL CO: SUCCESS FOODS MA,294.43,667.00
04/19,Withdrawal POS #310908142535...........................................  CIRCLE K 09847 COLORADO SPRN CO 5541,-2.30,664.70
04/19,Withdrawal Home Banking Transfer To Share 11....................  REF# 58864187,-300.00,364.70
04/19,Recurring Withdrawal Debit Card Visa Check..........................  APPLE.COM/BILL 866-712-7753 CA 5818,-0.99,363.71
04/19,Withdrawal Debit Card Visa Check...........................................  LOWES #00907* 866-483-7521 NC 5200,-14.29,349.42
04/19,Withdrawal POS #310918339070...........................................  CIRCLE K 09847 COLORADO SPRN CO 5541,-22.80,326.62
04/20,Withdrawal Debit Card Visa Check...........................................  IBI*FABLETICS.COM 855-2023570 CA 5968,-16.92,309.70
04/20,Withdrawal Debit Card Visa Check...........................................  RAISING CANES 0468 COLORADO SPRI TX 5814,-22.70,287.00
04/20,Withdrawal POS #311018519384...........................................  KUM&GO 0665R CO SPRIN CO SPRINGS CO 5541,-3.05,283.95
04/20,Withdrawal POS #311020267037...........................................  CIRCLE K 09847 COLORADO SPRN CO 5541,-7.99,275.96
04/21,Withdrawal Debit Card Visa Check...........................................  McDonalds 11078 COLORADO SPRI CO 5814,-6.04,269.92
04/21,Withdrawal Debit Card Visa Check...........................................  094 TORCHYS COLORADO SP COLORADO SPRI CO 5812,-6.61,263.31
04/21,"Deposit Home Banking Transfer REF# 58958361....................  From HODGES,JUSTINE B 532694 Share 10",130.00,393.31
04/21,Withdrawal Debit Card Visa Check...........................................  Equal Housing Opportunity Ent is a registered trademark of Ent Credit Union Insured by NCUA AccountNumber 1159412 StatementPeriod04/01/23thru04/30/23 Page 7 of 10 1111111111111111111111010011001101110011001110011010100110010001010000001100010011000011101010101010000001001100001100010011000001011000101110000000000001000101010010100100110111000110000100101101010110100011111000011111110011100111111011001101010111011001101100111010111011011011110101001110110000010010010111111000100010000111010011011101110001010111101100111011101111100100010011000110000010111001101011101110111111010010110000010100010110100000001001001011010101010101010101010101 No Strings Checking - 10 NO STRINGS CHECKING (continued) TransDate EffDate TransactionDescription Amount Balance LEVELUPSMOOTHIEKING64 855-466-5585 MA 5812,-15.13,378.18
04/22,Withdrawal Debit Card Visa Check...........................................  2574PEPSIVEN9147678600 COLORADO SPRI CO 5814,-2.25,375.93
04/22,Withdrawal POS #311212637740...........................................  SAFEWAY #4615 FALCON CO 5411,-4.48,371.45
04/22,Withdrawal Debit Card Visa Check...........................................  LOWES #00907* 866-483-7521 NC 5200,-186.60,184.85
04/23,Withdrawal POS #311310101087...........................................  LOWEâ€™S #2423 COLORADOSPRIN CO 5200,-27.92,156.93
04/23,Withdrawal POS #311311077917...........................................  MAVERIK #608 COLORADO SPRI CO 5541,-7.88,149.05
04/23,Withdrawal POS #311313679135...........................................  KUM&GO 0665R CO SPRIN CO SPRINGS CO 5541,-7.39,141.66
04/23,Withdrawal Debit Card Visa Check...........................................  094 TORCHYS COLORADO SP COLORADO SPRI CO 5812,-5.62,136.04
04/23,Withdrawal Debit Card Visa Check...........................................  SONIC #4735 PEYTON CO 5814,-11.66,124.38
04/24,Withdrawal Debit Card Visa Check...........................................  094 TORCHYS COLORADO SP COLORADO SPRI CO 5812,-7.40,116.98
04/24,Withdrawal Debit Card Visa Check...........................................  094 TORCHYS COLORADO SP COLORADO SPRI CO 5812,-6.55,110.43
04/25,Withdrawal Debit Card Visa Check...........................................  PANDA EXPRESS 700 COLORADO SPRI CO 5814,-12.98,97.45
04/25,Withdrawal Debit Card Visa Check...........................................  094 TORCHYS COLORADO SP COLORADO SPRI CO 5812,-3.56,93.89
04/25,Withdrawal Debit Card Visa Check...........................................  RAISING CANES 0468 COLORADO SPRI TX 5814,-10.81,83.08
04/26,Withdrawal Debit Card Visa Check...........................................  CIRCLE K 09874 COLORADO SPRI CO 5499,-5.96,77.12
04/26,Withdrawal POS #311617341562...........................................  TRADER JOE S #30 TRADER COLORADO SPRI CO 5411,-3.79,73.33
04/26,Withdrawal Debit Card Visa Check...........................................  Equal Housing Opportunity Ent is a registered trademark of Ent Credit Union Insured by NCUA 379361-1.18-61933N11.no8 026847743 4-5 AccountNumber 1159412 StatementPeriod04/01/23thru04/30/23 Page 8 of 10 No Strings Checking - 10 NO STRINGS CHECKING (continued) TransDate EffDate TransactionDescription Amount Balance ALBERTACOS MEXICAN FOO COLORADO SPRI CO 5814,-18.10,55.23
04/26,Withdrawal Debit Card Visa Check...........................................  Subway 24261 Colorado Spri CO 5814,-25.55,29.68
04/26,Withdrawal Debit Card Visa Check...........................................  LEVELUPSMOOTHIEKING26 855-466-5585 MA 5812,-17.84,11.84
04/27,Withdrawal POS #311709310084...........................................  CIRCLE K 09847 COLORADO SPRN CO 5541,-7.63,4.21
04/27,Deposit Home Banking Transfer From Share 12......................  REF# 59088361,160.00,164.21
04/27,Withdrawal POS #311718079487...........................................  EMPIRE 8154 COLORADO SPRI CO 5541,-23.86,140.35
04/28,Withdrawal Debit Card Visa Check...........................................  CIRCLE K 09847 COLORADO SPRI CO 5542,-57.00,83.35
04/28,Deposit ACH UNIVERSITY OF CO............................................  TYPE: DIR DEP CO: UNIVERSITY OF CO DEP PRENOTIFICATION FROM UNIVERSITY OF CO,590.62,673.97
04/28,Withdrawal Debit Card Visa Check...........................................  RED ROBIN NO 207 COLORADO SPRI CO 5812,-56.34,617.63
04/28,Withdrawal POS #311814001015...........................................  MAVERIK #608 COLORADO SPRI CO 5542,-20.04,597.59
04/28,Withdrawal Debit Card Visa Check...........................................  RAISING CANES 0468 COLORADO SPRI TX 5814,-10.61,586.98
04/28,Withdrawal Debit Card Visa Check...........................................  094 TORCHYS COLORADO SP COLORADO SPRI CO 5812,-6.79,580.19
04/28,Withdrawal POS #311800016990...........................................  KING SOOPERS #0119 9225 N. UNION COLORADO SPRI CO 5411,-54.92,525.27
04/28,Withdrawal Debit Card Visa Check...........................................  LEVELUPSMOOTHIEKING01 855-466-5585 MA 5812,-15.13,510.14
04/29,Withdrawal POS #311900605798...........................................  SEI 33710 6040 BARNES RD US COLORADO SPRI CO 5541,-9.30,500.84
04/29,Withdrawal POS #311912403090...........................................  COSTCO WHSE #1014 COLORADO SPRI CO 5300,-180.40,320.44
04/30,Withdrawal Debit Card Visa Check...........................................  094 TORCHYS COLORADO SP COLORADO SPRI CO 5812,-6.61,313.83
04/30,Withdrawal POS #312020541666...........................................  KING SOOPERS #01 9225 N COLORADO SPRI CO Equal Housing Opportunity Ent is a registered trademark of Ent Credit Union Insured by NCUA AccountNumber 1159412 StatementPeriod04/01/23thru04/30/23 Page 9 of 10 1111111111111111111111010001001101110101001110011010100110000001010000001100010011000011101010101010000001010100001100010011000011011000101110000000110011000101010010100100010111000110000100011101010110100011111000001011110011100111001001111101010111011000110110111010111011000000010001011110110001111110101111111000111011000010110011111101110001111111101010100011001001100100111101101111111101111001111111111010101111010100010011010100000110100110111000101011110101010101010101010101 No Strings Checking - 10 NO STRINGS CHECKING (continued) TransDate EffDate TransactionDescription Amount Balance 5411,-61.69,252.14
04/30,"Deposit Dividend Tiered Rate..................................................  Annual Percentage Yield Earned 0.030% for period: 04/01/23 to 04/30/23 Ending Balance............................................................................. 252.15 No Strings Checking - 11 NO STRINGS CHECKING Dividends Earned YTD: 0.05 JointOwner:TYMITCHELL Beginning Balance + Deposits & Other Credits (4) - Checks Cleared (0) - Withdrawals & Other Debits (0) = Ending Balance $0.01 $1,200.04 $0.00 $0.00 $1,200.05 TransDate EffDate TransactionDescription Amount Balance Beginning Balance......................................................................... 0.01",0.01,252.15
04/04,"Deposit Home Banking Transfer REF# 58451730....................  From HODGES,JUSTINE B 532694 Share 10",600.00,600.01
04/06,"Deposit Home Banking Transfer REF# 58499861....................  From HODGES,JUSTINE B 532694 Share 01",300.00,900.01
04/19,Deposit Home Banking Transfer From Share 10......................  REF# 58864187,300.00,"1,200.01"
04/30,"Deposit Dividend Tiered Rate..................................................  Annual Percentage Yield Earned 0.050% for period: 04/01/23 to 04/30/23 Ending Balance............................................................................. 1,200.05 No Strings Checking - 12 NO STRINGS CHECKING Dividends Earned YTD: 0.01 JointOwner:TYMITCHELL Beginning Balance + Deposits & Other Credits (2) - Checks Cleared (0) - Withdrawals & Other Debits (2) = Ending Balance $150.00 $150.01 $0.00 $300.00 $0.01 TransDate EffDate TransactionDescription Amount Balance Beginning Balance......................................................................... 150.00",0.04,"1,200.05"
04/06,Deposit Home Banking Transfer From Share 10......................  REF# 58489894,150.00,300.00
04/08,Withdrawal Home Banking Transfer To Share 10....................  REF# 58563927,-140.00,160.00
04/27,Withdrawal Home Banking Transfer To Share 10....................  REF# 59088361,-160.00,0.00
04/30,Deposit Dividend Tiered Rate..................................................  Annual Percentage Yield Earned 0.080% for period: 04/01/23 to 04/30/23 Ending Balance............................................................................. 0.01 Equal Housing Opportunity Ent is a registered trademark of Ent Credit Union Insured by NCUA 379361-1.18-61933N11.no8 026847743 5-5 AccountNumber 1159412 StatementPeriod04/01/23thru04/30/23 Page 10 of 10 No Strings Checking - 13 NO STRINGS CHECKING Dividends Earned YTD: 0.01 JointOwner:TYMITCHELL Beginning Balance + Deposits & Other Credits (3) - Checks Cleared (0) - Withdrawals & Other Debits (3) = Ending Balance $120.00 $210.01 $0.00 $236.00 $94.01 TransDate EffDate TransactionDescription Amount Balance Beginning Balance......................................................................... 120.00,0.01,0.01
04/04,Withdrawal Home Banking Transfer To Share 10....................  REF# 58451489,-56.00,64.00
04/04,Deposit Home Banking Transfer From Share 10......................  REF# 58451518,150.00,214.00
04/06,Deposit Home Banking Transfer From Share 10......................  REF# 58489897,60.00,274.00
04/12,"Withdrawal Home Banking Transfer REF# 58656095..............  To HODGES,JUSTINE B 532694 Share 10",-40.00,234.00
04/24,"Withdrawal Home Banking Transfer........................................  To HODGES,JUSTINE B 532694 Share 10 REF# 59012041 VILLA",-140.00,94.00
04/30,"Deposit Dividend Tiered Rate..................................................  Annual Percentage Yield Earned 0.060% for period: 04/01/23 to 04/30/23 Ending Balance............................................................................. 94.01 YEAR-TO-DATE DIVIDEND SUMMARY Reportable Dividends this Year:............................................................................. 0.16 Reportable dividends of $10.00 or more are reported to the IRS as interest income for the year. ** The Visa Foreign Currency Transaction Fee will be assessed to purchases made outside of the United States as well as to online purchases made within the United States, but the merchant is located outside the United States. ** No-cost loan payment alternatives are available, please call 800-525-9623 for more information. Equal Housing Opportunity Ent is a registered trademark of Ent Credit Union Insured by NCUA",0.01,94.01
08/04,Deposit ACH UNIVERSITY OF CO............................................  TYPE: DIR DEP CO: UNIVERSITY OF CO,216.86,223.10
08/06,Withdrawal Home Banking Transfer To Share 10....................  REF# 62131774,-120.00,103.10
08/07,Withdrawal Transfer To Share 10............................................ ,-66.38,36.72
08/07,Withdrawal Transfer To Share 10............................................ ,-12.97,23.75
08/08,Withdrawal Transfer To Share 10............................................  DEP PRENOTIFICATION FROM Colorado Springs,-15.41,8.34
08/10,Withdrawal Transfer To Share 10............................................ ,-3.34,5.00
08/10,"Deposit Home Banking Transfer REF# 62237311....................  From HODGES,JUSTINE B 532694 Share 00",100.00,105.00
08/10,Withdrawal Home Banking Transfer To Share 10....................  REF# 62244036,-90.00,15.00
08/18,Deposit ACH UNIVERSITY OF CO............................................  TYPE: DIR DEP CO: UNIVERSITY OF CO,233.24,248.24
08/20,Deposit at ATM #000000007422.............................................  ENT CREDIT UNION 7020 CAMPUS DRIVE Equal Housing Opportunity Ent is a registered trademark of Ent Credit Union Insured by NCUA AccountNumber 1159412 StatementPeriod08/01/23thru08/31/23 Page 2 of 13 Primary Savings - 00 PRIMARY SAVINGS (continued) TransDate EffDate TransactionDescription Amount Balance COLORADO SPRI CO,"1,225.00","1,473.24"
08/20,Deposit at ATM #000000007423.............................................  ENT CREDIT UNION 7020 CAMPUS DRIVE COLORADO SPRI CO,"1,630.00","3,103.24"
08/21,Withdrawal Home Banking Transfer To Share 10....................  REF# 62561047,-160.00,"2,943.24"
08/21,Withdrawal Home Banking Transfer To Share 10....................  REF# 62561103,-25.00,"2,918.24"
08/23,"Withdrawal Home Banking Transfer REF# 62611037..............  To HODGES,JUSTINE B 532694 Share 00",-500.00,"2,418.24"
08/23,Withdrawal Home Banking Transfer To Share 10....................  REF# 62611048,-350.00,"2,068.24"
08/24,Withdrawal Home Banking Transfer To Share 10....................  REF# 62642305,-130.00,"1,938.24"
08/24,Withdrawal Home Banking Transfer To Share 10....................  REF# 62651577,-215.00,"1,723.24"
08/25,Deposit ACH Colorado Springs................................................  TYPE: PR PAYMENT CO: Colorado Springs,113.47,"1,836.71"
08/26,Withdrawal Home Banking Transfer To Share 10....................  REF# 62713024,-600.00,"1,236.71"
08/27,Withdrawal Home Banking Transfer To Share 10....................  REF# 62734632,-200.00,"1,036.71"
08/31,"Deposit Dividend 0.050%........................................................  Annual Percentage Yield Earned 0.050% for period: 08/01/23 to 08/31/23 Ending Balance............................................................................. 1,036.74 No Strings Checking - 10 NO STRINGS CHECKING Dividends Earned YTD: 0.05 JointOwner:TYMITCHELL Beginning Balance + Deposits & Other Credits (33) - Checks Cleared (0) - Withdrawals & Other Debits (110)= Ending Balance $150.42 $7,706.54 $0.00 $7,759.04 $97.92 TransDate EffDate TransactionDescription Amount Balance Beginning Balance......................................................................... 150.42",0.03,"1,036.74"
08/01,"Deposit Home Banking Transfer REF# 61951582....................  From HODGES,JUSTINE B 532694 Share 10",57.00,207.42
08/01,"Deposit Home Banking Transfer REF# 61951681....................  Equal Housing Opportunity Ent is a registered trademark of Ent Credit Union Insured by NCUA AccountNumber 1159412 StatementPeriod08/01/23thru08/31/23 Page 3 of 13 1111111111111111111111010011001100110111001110011000100010000001110000001101110011000001101011100010000001111100001111100011000011011000100110000000111111000101110010100100110111001010000100110101010101000011111011101011111010000111000000001100100101011011100011111110000011111100010011011100110011000001011111001000101011001110010000001100001100000111111010011001011110100101111010010010110010011110101101101001100111001011010000001100100111000110001000001010110101010101010101010101 No Strings Checking - 10 NO STRINGS CHECKING (continued) TransDate EffDate TransactionDescription Amount Balance From HODGES,JUSTINE B 532694 Share 00",59.30,266.72
08/01,Withdrawal Adjustment Debit Card Credit Voucher.................  BOOTBARN.COM 888-440-2668 CA 5661,309.66,576.38
08/02,Withdrawal Debit Card Visa Check...........................................  AMZN Mktp US*TH6BW6D10 Amzn.com/bill WA 5942,-203.65,372.73
08/02,Withdrawal Debit Card Visa Check...........................................  AMZN Mktp US*TH7MR6D90 Amzn.com/bill WA 5942,-8.65,364.08
08/02,Withdrawal Home Banking Transfer To Share 11....................  REF# 61993259,-200.00,164.08
08/02,Recurring Withdrawal #321421106093...................................  Audible*TH6FO2M21 Amzn.com/bill NJ,-16.18,147.90
08/03,Withdrawal Debit Card Visa Check...........................................  McDonalds 26480 COLORADO SPRI CO 5814,-3.33,144.57
08/03,Withdrawal Debit Card Visa Check...........................................  2574PEPSIVEN9147678600 COLORADO SPRI CO 5814,-3.10,141.47
08/03,Recurring Withdrawal Debit Card Visa Check..........................  APPLE.COM/BILL 866-712-7753 CA 5818,-0.99,140.48
08/03,Withdrawal Debit Card Visa Check...........................................  KUM&GO 0659R CO SPRIN CO SPRINGS CO 5541,-7.46,133.02
08/03,"Deposit Home Banking Transfer REF# 62036259....................  From HODGES,JUSTINE B 532694 Share 00",275.00,408.02
08/04,Deposit ACH UNIVERSITY OF CO............................................  TYPE: DIR DEP CO: UNIVERSITY OF CO,867.46,"1,275.48"
08/04,Withdrawal Home Banking Transfer To Share 11....................  REF# 62069132,-300.00,975.48
08/04,"Withdrawal Home Banking Transfer REF# 62069143..............  To HODGES,JUSTINE B 532694 Share 01",-100.00,875.48
08/04,"Withdrawal Home Banking Transfer REF# 62069166..............  To HODGES,JUSTINE B 532694 Share 11 Equal Housing Opportunity Ent is a registered trademark of Ent Credit Union Insured by NCUA 397914-1.58-51407N11.no7 029314349 2-7 AccountNumber 1159412 StatementPeriod08/01/23thru08/31/23 Page 4 of 13 No Strings Checking - 10 NO STRINGS CHECKING (continued) TransDate EffDate TransactionDescription Amount Balance",-35.00,840.48
08/04,"Withdrawal Home Banking Transfer REF# 62069186..............  To HODGES,JUSTINE B 532694 Share 12",-100.00,740.48
08/04,Withdrawal Home Banking Transfer To Share 13....................  REF# 62069205,-140.00,600.48
08/05,Withdrawal Debit Card Visa Check...........................................  VENMO* Visa Direct NY 4829,-15.00,585.48
08/05,Withdrawal Debit Card Visa Check...........................................  CHICK-FIL-A #02342 COLO SPGS CO 5814,-18.48,567.00
08/06,Withdrawal Debit Card Visa Check...........................................  MENS WEARHOUSE #1307 COLORADO SPRI CO 5611,-65.40,501.60
08/06,Withdrawal Debit Card Visa Check...........................................  BAD DADDYâ€™S BURGER BAR COLORADO SPRI CO 5812,-57.00,444.60
08/06,Withdrawal POS #321815699849...........................................  COSTCO WHSE #1014 COLORADO SPRI CO 5300,-104.43,340.17
08/06,Withdrawal POS #321819427209...........................................  KING SOOPERS #01 9225 N COLORADO SPRI CO 5411,-121.26,218.91
08/06,Withdrawal Debit Card Visa Check...........................................  AMZN Mktp US*TA8UX4E40 Amzn.com/bill WA 5942,-141.42,77.49
08/06,Deposit Home Banking Transfer From Share 00......................  REF# 62131774,120.00,197.49
08/06,Withdrawal Debit Card Visa Check...........................................  LEVELUPSMOOTHIEKING26 855-466-5585 MA 5812,-21.06,176.43
08/07,08/06 Withdrawal Debit Card Visa Check...........................................  GARDEN OF THE GODS LIQU COLORADO SPRI CO 5921,-22.59,153.84
08/07,Withdrawal Debit Card Visa Check...........................................  Amazon.com*TA3GE9HQ2 Amzn.com/bill WA 5942,-94.36,59.48
08/07,Recurring Withdrawal Debit Card Visa Check..........................  COOKBOOK MOUNT COOLUM AU 5817,-1.49,57.99
08/07,Recurring Withdrawal Card Fee...............................................  VISA INTERNATIONAL SERVICE ASSESSMENT Date 08/07/23 W/D PRENOTIFICATION FROM SAFECO INSURANCE,-0.01,57.98
08/07,Withdrawal NSF Fee.................................................................  In the amount $275.00 SAFECO INS. CO.,-30.00,27.98
08/07,Deposit Transfer From Share 00..............................................  Equal Housing Opportunity Ent is a registered trademark of Ent Credit Union Insured by NCUA AccountNumber 1159412 StatementPeriod08/01/23thru08/31/23 Page 5 of 13 1111111111111111111111010011001100110001001110011000100010000001110000001101110011000001101011100010000001000100001111100011000000111000100110000000010001000101110010100111110111001010000100110001010101000011111011110111111010000111010011011101100101011011010111111010000011110100100001001100110000111111011111001000001000010011010000001101111011010111111010110101000100000101010010000100100110011100110110011100100111000110110001011100110111000110001000101011010101010101010101010101 No Strings Checking - 10 NO STRINGS CHECKING (continued) TransDate EffDate TransactionDescription Amount Balance,66.38,94.36
08/07,Withdrawal Debit Card Visa Check...........................................  Amazon.com*TA5T87TQ1 Amzn.com/bill WA 5942,-94.36,0.00
08/07,Deposit Transfer From Share 00.............................................. ,12.97,12.97
08/07,Withdrawal POS #321921031047...........................................  PETCO 1472 COLORADO SPRI CO 5995,-12.97,0.00
08/08,Deposit Transfer From Share 00.............................................. ,15.41,15.41
08/08,Withdrawal Debit Card Visa Check...........................................  TARGET 00022210 COLORADO SPRI CO 5411,-15.41,0.00
08/08,"Deposit Home Banking Transfer REF# 62179031....................  From HODGES,JUSTINE B 532694 Share 00",50.00,50.00
08/08,Deposit Home Banking Transfer From Share 13......................  REF# 62191909,75.00,125.00
08/09,Withdrawal Debit Card Visa Check...........................................  AMZN Mktp US*TA0RF85F1 Amzn.com/bill WA 5942,-21.88,103.12
08/09,Withdrawal Debit Card Visa Check...........................................  CO E-GOV SERVICES EMV 303-534-3468 CO 9399,-2.50,100.62
08/09,"Deposit Home Banking Transfer REF# 62204653....................  From HODGES,JUSTINE B 532694 Loan 01",300.00,400.62
08/09,Withdrawal Debit Card Visa Check...........................................  AMZN Mktp US*TA75J5I52 Amzn.com/bill WA 5942,-7.73,392.89
08/09,Withdrawal Debit Card Visa Check...........................................  KUM&GO 0659R CO SPRIN CO SPRINGS CO 5542,-70.02,322.87
08/09,Withdrawal Debit Card Visa Check...........................................  SQ *K BARBER NEXT LEVEL Colorado Spri CO 7230,-40.50,282.37
08/09,Withdrawal Debit Card Visa Check...........................................  VENMO* Visa Direct NY 4829,-100.00,182.37
08/09,Withdrawal Debit Card Visa Check...........................................  PP*DUTCHBROSLL GRANTS PASS OR 5499,-14.05,168.32
08/10,08/09 Withdrawal Debit Card Visa Check...........................................  PRICELN*COURTYARD BY M 203-299-8000 CT 4722 Equal Housing Opportunity Ent is a registered trademark of Ent Credit Union Insured by NCUA 397914-1.58-51407N11.no7 029314349 3-7 AccountNumber 1159412 StatementPeriod08/01/23thru08/31/23 Page 6 of 13 No Strings Checking - 10 NO STRINGS CHECKING (continued) TransDate EffDate TransactionDescription Amount Balance,-139.70,28.62
08/10,Deposit Transfer From Share 00..............................................  KUM&GO 0667R CO SPRIN CO SPRINGS CO 5542,3.34,31.96
08/10,Deposit Home Banking Transfer From Share 13......................  REF# 62237470,65.00,56.96
08/10,Withdrawal Debit Card Visa Check...........................................  ULTA #779 COLORADO SPRI CO 5977,-47.95,9.01
08/10,Deposit Home Banking Transfer From Share 00......................  REF# 62244036,90.00,99.01
08/10,"Deposit Home Banking Transfer REF# 62246273....................  From HODGES,JUSTINE B 532694 Share 00",50.00,149.01
08/11,Withdrawal Debit Card Visa Check...........................................  SUMUP *TENACIOUS SPRAY COLORADO SPRI CO 7230,-86.25,62.76
08/11,Withdrawal Debit Card Visa Check...........................................  CO DRIVER SERVICES DENVER CO 9399,-32.33,30.43
08/11,Deposit ACH Colorado Springs................................................  TYPE: PR PAYMENT CO: Colorado Springs,"1,318.98","1,349.41"
08/11,Withdrawal Home Banking Transfer To Share 11....................  REF# 62265767,-300.00,"1,049.41"
08/11,Withdrawal Home Banking Transfer To Share 13....................  REF# 62265789,-160.00,889.41
08/11,"Withdrawal Home Banking Transfer REF# 62265931..............  To HODGES,JUSTINE B 532694 Share 11",-70.00,819.41
08/11,"Withdrawal Home Banking Transfer REF# 62265952..............  To HODGES,JUSTINE B 532694 Share 01",-150.00,669.41
08/11,"Withdrawal Home Banking Transfer REF# 62266000..............  To HODGES,JUSTINE B 532694 Share 12",-100.00,569.41
08/11,Withdrawal Debit Card Visa Check...........................................  TARGET 00015016 COLORADO SPRI CO 5411,-16.73,552.68
08/11,Recurring Withdrawal #322320700689...................................  ADOBE CREATIVE CLOUD 408-536-6000 CA,-20.60,532.08
08/11,Withdrawal Debit Card Visa Check...........................................  2574PEPSIVEN9147678600 COLORADO SPRI CO 5814,-3.10,528.98
08/12,Withdrawal Debit Card Visa Check...........................................  Equal Housing Opportunity Ent is a registered trademark of Ent Credit Union Insured by NCUA AccountNumber 1159412 StatementPeriod08/01/23thru08/31/23 Page 7 of 13 1111111111111111111111010011001100110011001110011000100010010001110000001101110011000001101011100010000001001100001111100011000010011000100110000000010001000101110010100101010111001010000100011111010101000011111001101011111010000111110000011101100101011001011111111010000011101000011111011100110011000011011111001000001101001011110001011110101010001111111111101111111111000100000011111001110111011000110101001100011111001010010010010100110111000010001001001011010101010101010101010101 No Strings Checking - 10 NO STRINGS CHECKING (continued) TransDate EffDate TransactionDescription Amount Balance ULTA #133 COLORADO SPRI CO 5977,-32.46,496.52
08/12,Withdrawal Debit Card Visa Check...........................................  IN N OUT BURGER 359 COLORADO SPRI CO 5814,-14.31,482.21
08/13,Withdrawal POS #322500936784...........................................  SEI 33042 8750 S YOSEMITE US LONE TREE CO 5542,-74.05,408.16
08/14,Recurring Withdrawal #322610607420...................................  8667127753 APPLE COM BILL CUPERTINO CA,-15.99,392.17
08/14,Withdrawal POS #322617831031...........................................  KING SOOPERS #01 9225 N COLORADO SPRI CO 5411,-7.43,384.74
08/14,Withdrawal POS #322614660112...........................................  COSTCO WHSE #1014 COLORADO SPRI CO 5300,-151.88,232.86
08/14,Withdrawal Debit Card Visa Check...........................................  BJS RESTAURANTS 502 COLORADO SPRI CO 5812 Amazon.com Pending credit/return for $94.08 on card 0950 Amazon.com Pending credit/return for $94.08 on card 0950,-32.00,200.86
08/14,Withdrawal Adjustment Debit Card Credit Voucher.................  Amazon.com Amzn.com/bill WA 5942,94.08,294.94
08/14,Withdrawal Adjustment Debit Card Credit Voucher.................  Amazon.com Amzn.com/bill WA 5942,94.08,389.02
08/14,Recurring Withdrawal Debit Card Visa Check..........................  APPLE.COM/BILL 866-712-7753 CA 5818,-0.99,388.03
08/15,Withdrawal Debit Card Visa Check...........................................  SCHEELS COLORADO SPRING COLORADO SPRI CO 5941,-58.05,329.98
08/15,Withdrawal Debit Card Visa Check...........................................  KUM&GO 0659R CO SPRIN CO SPRINGS CO 5541,-6.23,323.75
08/15,Recurring Withdrawal Debit Card Visa Check..........................  KING SOOPERS #5119 866-576-4377 CO 5411,-52.13,271.62
08/15,Withdrawal Debit Card Visa Check...........................................  Equal Housing Opportunity Ent is a registered trademark of Ent Credit Union Insured by NCUA 397914-1.58-51407N11.no7 029314349 4-7 AccountNumber 1159412 StatementPeriod08/01/23thru08/31/23 Page 8 of 13 No Strings Checking - 10 NO STRINGS CHECKING (continued) TransDate EffDate TransactionDescription Amount Balance RAISING CANES 0403 COLORADO SPRI CO 5814,-18.94,252.68
08/15,Withdrawal Debit Card Visa Check...........................................  SQ *LUMPIA HOUSE LLC Colorado Spri CO 5814,-13.55,239.13
08/16,"Deposit Home Banking Transfer REF# 62410598....................  From HODGES,JUSTINE B 532694 Share 00",172.00,411.13
08/16,Withdrawal Debit Card Visa Check...........................................  2574PEPSIVEN9147678600 COLORADO SPRI CO 5814,-3.10,408.03
08/18,Deposit ACH UNIVERSITY OF CO............................................  TYPE: DIR DEP CO: UNIVERSITY OF CO,932.94,"1,340.97"
08/18,Withdrawal Home Banking Transfer To Share 11....................  REF# 62464997,-300.00,"1,040.97"
08/18,"Withdrawal Home Banking Transfer REF# 62465057..............  To HODGES,JUSTINE B 532694 Share 11",-35.00,"1,005.97"
08/18,"Withdrawal Home Banking Transfer REF# 62465073..............  To HODGES,JUSTINE B 532694 Share 01",-100.00,905.97
08/18,"Withdrawal Home Banking Transfer REF# 62465075..............  To HODGES,JUSTINE B 532694 Share 12 AMZN Mktp US Pending credit/return for $94.08 on card 0950",-100.00,805.97
08/18,Withdrawal Adjustment Debit Card Credit Voucher.................  AMZN Mktp US Amzn.com/bill WA 5942,94.08,900.05
08/19,Withdrawal POS #323115711152...........................................  KING SOOPERS #01 9225 N COLORADO SPRI CO 5411,-31.37,868.68
08/19,Withdrawal Debit Card Visa Check...........................................  crypto.com Miami FL 6051,-370.65,498.03
08/20,Withdrawal Debit Card Visa Check...........................................  SP TRUECLASSICTEES.C HTTPSTRUECLAS CA 5611,-130.33,367.70
08/20,Withdrawal POS #323200116086...........................................  KING SOOPERS #719 FUEL 9255 N UNION BL COLORADO SPRI CO 5542,-64.76,302.94
08/20,Withdrawal POS #323213832536...........................................  COSTCO WHSE #1014 COLORADO SPRI CO 5300,-109.20,193.74
08/20,Withdrawal POS #323220528080...........................................  KING SOOPERS #01 9225 N COLORADO SPRI CO 5411 Equal Housing Opportunity Ent is a registered trademark of Ent Credit Union Insured by NCUA AccountNumber 1159412 StatementPeriod08/01/23thru08/31/23 Page 9 of 13 1111111111111111111111010011001100110101001110011000100010000001110000001101110011000001101011100010000001101100001111100011000000111000100110000000111101000101110010100110010111001010000100001001010101000011111011001011111010000111101000011101100101011010011010111110000011001011100111001100110011100111110111001000111101000011110001101101011010000111111010101101010111100100100100111111101000011111111011101110000111000011110000000100010111000110001000101011110101010101010101010101 No Strings Checking - 10 NO STRINGS CHECKING (continued) TransDate EffDate TransactionDescription Amount Balance,-45.22,148.52
08/21,Withdrawal Debit Card Visa Check...........................................  KUM&GO 0659R CO SPRIN CO SPRINGS CO 5541,-15.22,133.30
08/21,Recurring Withdrawal Debit Card Visa Check..........................  KING SOOPERS #5119 866-576-4377 CO 5411,-83.98,49.32
08/21,Deposit Home Banking Transfer From Share 00......................  REF# 62561047,160.00,209.32
08/21,Deposit Home Banking Transfer From Share 00......................  REF# 62561103,25.00,234.32
08/21,Deposit Home Banking Transfer From Share 13......................  REF# 62562789,85.00,319.32
08/21,Withdrawal POS #323300126576...........................................  KING SOOPERS #719 FUEL 9255 N UNION BL COLORADO SPRI CO 5542,-77.64,241.68
08/22,Withdrawal Debit Card Visa Check...........................................  2574PEPSIVEN9147678600 COLORADO SPRI CO 5814,-3.10,238.58
08/23,Withdrawal Debit Card Visa Check...........................................  AMZN Mktp US*TQ58I0QG0 Amzn.com/bill WA 5942,-199.22,39.36
08/23,Withdrawal Debit Card Visa Check...........................................  VENMO* Visa Direct NY 4829,-15.00,24.36
08/23,Deposit Home Banking Transfer From Share 00......................  REF# 62611048,350.00,374.36
08/23,Withdrawal POS #323500415517...........................................  TJMAXX #0251 3999 PALMER PARK BLVD. COLORADO SPRI CO 5310,-51.89,322.47
08/24,Withdrawal Debit Card Visa Check...........................................  KUM&GO 0659R CO SPRIN CO SPRINGS CO 5541,-11.27,311.20
08/24,Withdrawal Debit Card Visa Check...........................................  BUFF CITY SOAP - DUBLIN COLORADO SPRI CO 5099,-41.68,269.52
08/24,Withdrawal Debit Card Visa Check...........................................  PLATOâ€™S CLOSET COLORADO SPRI CO 5931,-61.66,207.86
08/24,Deposit Home Banking Transfer From Share 00......................  Equal Housing Opportunity Ent is a registered trademark of Ent Credit Union Insured by NCUA 397914-1.58-51407N11.no7 029314349 5-7 AccountNumber 1159412 StatementPeriod08/01/23thru08/31/23 Page 10 of 13 No Strings Checking - 10 NO STRINGS CHECKING (continued) TransDate EffDate TransactionDescription Amount Balance REF# 62642305,130.00,337.86
08/24,Deposit Home Banking Transfer From Share 00......................  REF# 62651577,215.00,552.86
08/24,Withdrawal Debit Card Visa Check...........................................  CHICK-FIL-A #03985 COLORADO SPRI CO 5814,-10.44,542.42
08/25,Withdrawal Debit Card Visa Check...........................................  APPLE.COM/BILL 866-712-7753 CA 5818,-64.87,477.55
08/25,Withdrawal Debit Card Visa Check...........................................  IK MULTIMEDIA US LLC 9548469101 FL 5732,-216.39,261.16
08/25,Withdrawal Debit Card Visa Check...........................................  GUITARCENTER.COM INTERN 866-498-7882 CA 5733,-140.65,120.51
08/25,Deposit ACH Colorado Springs................................................  TYPE: PR PAYMENT CO: Colorado Springs,605.23,725.74
08/25,Withdrawal Debit Card Visa Check...........................................  CHEBA HUT- COLORADO SPR COLORADO SPRI CO 5812,-29.74,696.00
08/25,Withdrawal Debit Card Visa Check...........................................  CHEBA HUT- COLORADO SPR COLORADO SPRI CO 5812,-3.26,692.74
08/25,Withdrawal Home Banking Transfer To Share 11....................  REF# 62681663,-300.00,392.74
08/25,Withdrawal POS #323800833669...........................................  KING SOOPERS #01 9225 N COLORADO SPRI CO 5411,-8.78,383.96
08/25,Withdrawal Debit Card Visa Check...........................................  VENMO* Visa Direct NY 4829,-18.00,365.96
08/26,Withdrawal Debit Card Visa Check...........................................  AMZN Mktp US*T30ZT3Z50 Amzn.com/bill WA 5942,-10.01,355.95
08/26,Deposit Home Banking Transfer From Share 00......................  REF# 62713024,600.00,955.95
08/26,Withdrawal Debit Card Visa Check...........................................  RAISING CANES 0403 COLORADO SPRI CO 5814,-12.66,943.29
08/27,Withdrawal Debit Card Visa Check...........................................  SCHEELS COLORADO SPRING COLORADO SPRI CO 5941,-516.05,427.24
08/27,Withdrawal Debit Card Visa Check...........................................  DUTCH BROS 541-955-4700 OR 5814 Equal Housing Opportunity Ent is a registered trademark of Ent Credit Union Insured by NCUA AccountNumber 1159412 StatementPeriod08/01/23thru08/31/23 Page 11 of 13 1111111111111111111111010011001100110111001110011000100010010001110000001101110011000001101011100010000001100100001111100011000010011000100110000000111101000101110010100100110111001010000100100111010101000011111001010111111010000111001011011101100101011000010010111110000011010111011001011100110000011011110111001000111000011011010000111110001011011111111111110111101100100101110101000010111001011011111000111110111111001111010011001100010111000010001001001011110101010101010101010101 No Strings Checking - 10 NO STRINGS CHECKING (continued) TransDate EffDate TransactionDescription Amount Balance,-10.00,417.24
08/27,Withdrawal Debit Card Visa Check...........................................  TACO BELL 037416 COLORADO SPRI CO 5814 SCHEELS COLORADO SPRING Pending credit/return for $213.62 on card 0950,-10.87,406.37
08/27,Deposit Home Banking Transfer From Share 00......................  REF# 62734632,200.00,606.37
08/27,Withdrawal POS #323918639992...........................................  COSTCO WHSE #1014 COLORADO SPRI CO 5300,-127.08,479.29
08/27,Withdrawal Debit Card Visa Check...........................................  DUTCH BROS 541-955-4700 OR 5814,-10.00,469.29
08/27,Withdrawal Debit Card Visa Check...........................................  POSHMARK 650-488-7740 CA 5931,-35.56,433.73
08/28,Withdrawal Adjustment Debit Card Credit Voucher.................  SCHEELS COLORADO SPRING COLORADO SPRI CO 5941,213.62,647.35
08/28,Withdrawal Debit Card Visa Check...........................................  SCHEELS COLORADO SPRING COLORADO SPRI CO 5941,-210.34,437.01
08/28,Withdrawal POS #324000117257...........................................  KING SOOPERS #719 FUEL 9255 N UNION BL COLORADO SPRI CO 5542,-70.58,366.43
08/28,Withdrawal Debit Card Visa Check...........................................  TACO BELL 037413 COLORADO SPRI CO 5814,-16.44,349.99
08/28,Withdrawal POS #324013343815...........................................  MURPHY EXPRESS 8984 COLORADO SPRI CO 5541,-2.89,347.10
08/28,Withdrawal Debit Card Visa Check...........................................  SP JIV ATHLETICS HTTPSJIVATHLE CA 5699,-68.40,278.70
08/28,Recurring Withdrawal Debit Card Visa Check..........................  KING SOOPERS #5119 866-576-4377 CO 5411,-65.31,213.39
08/28,Withdrawal Debit Card Visa Check...........................................  KUM&GO 0667R CO SPRIN CO SPRINGS CO 5541,-7.57,205.82
08/30,Withdrawal Debit Card Visa Check...........................................  POSHMARK 650-488-7740 CA 5931,-94.81,111.01
08/30,Withdrawal Debit Card Visa Check...........................................  Equal Housing Opportunity Ent is a registered trademark of Ent Credit Union Insured by NCUA 397914-1.58-51407N11.no7 029314349 6-7 AccountNumber 1159412 StatementPeriod08/01/23thru08/31/23 Page 12 of 13 No Strings Checking - 10 NO STRINGS CHECKING (continued) TransDate EffDate TransactionDescription Amount Balance DUTCH BROS 541-955-4700 OR 5814,-10.00,101.01
08/31,Withdrawal Debit Card Visa Check...........................................  2574PEPSIVEN9147678600 COLORADO SPRI CO 5814,-3.10,97.91
08/31,"Deposit Dividend Tiered Rate..................................................  Annual Percentage Yield Earned 0.030% for period: 08/01/23 to 08/31/23 Ending Balance............................................................................. 97.92 Total for this period Total year-to-date Total Courtesy Pay (Overdraft) Fees $0.00 $0.00 Total Returned Item (Non Sufficient Funds) Fees $30.00 $30.00 The information above is provided to assist you in the management of your checking account. Month to Date (MTD) figures only include fees assessed during the current month. Year to Date (YTD) totals reflect the net fees assessed for the current year. No Strings Checking - 11 NO STRINGS CHECKING Dividends Earned YTD: 0.18 JointOwner:TYMITCHELL Beginning Balance + Deposits & Other Credits (6) - Checks Cleared (0) - Withdrawals & Other Debits (1) = Ending Balance $100.14 $1,400.04 $0.00 $1,200.00 $300.18 TransDate EffDate TransactionDescription Amount Balance Beginning Balance......................................................................... 100.14",0.01,97.92
08/02,Deposit Home Banking Transfer From Share 10......................  REF# 61993259,200.00,300.14
08/04,Deposit Home Banking Transfer From Share 10......................  REF# 62069132,300.00,600.14
08/11,Deposit Home Banking Transfer From Share 10......................  REF# 62265767,300.00,900.14
08/18,Deposit Home Banking Transfer From Share 10......................  REF# 62464997,300.00,"1,200.14"
08/25,Deposit Home Banking Transfer From Share 10......................  REF# 62681663,300.00,"1,500.14"
08/30,Withdrawal Home Banking......................................................  ACH WITHDRAWAL US BANK NA - JUSTINE HODGES,"-1,200.00",300.14
08/31,Deposit Dividend Tiered Rate..................................................  Annual Percentage Yield Earned 0.050% for period: 08/01/23 to 08/31/23 Ending Balance............................................................................. 300.18 Equal Housing Opportunity Ent is a registered trademark of Ent Credit Union Insured by NCUA AccountNumber 1159412 StatementPeriod08/01/23thru08/31/23 Page 13 of 13 1111111111111111111111010001001100111001001110011000100010010001110000001101110011000001101011100010000001101100001111100011000010011000100110000000010101000101110010100110010111001010000100010001010101000011111010001011111010000111011101101100100101011010001100111010000011100000111001001100110000011010010111001000100000101100110001101100111111001111111100100100100001000101101101001001011001111001110001010011100011001000010000110100100111000100111000101010010101010101010101010101 No Strings Checking - 12 NO STRINGS CHECKING Dividends Earned YTD: 0.01 JointOwner:TYMITCHELL Beginning Balance + Deposits & Other Credits (0) - Checks Cleared (0) - Withdrawals & Other Debits (0) = Ending Balance $0.00 $0.00 $0.00 $0.00 $0.00 TransDate EffDate TransactionDescription Amount Balance Beginning Balance......................................................................... 0.00 Ending Balance............................................................................. 0.00 No Strings Checking - 13 NO STRINGS CHECKING Dividends Earned YTD: 0.01 JointOwner:TYMITCHELL Beginning Balance + Deposits & Other Credits (2) - Checks Cleared (0) - Withdrawals & Other Debits (3) = Ending Balance $0.00 $300.00 $0.00 $225.00 $75.00 TransDate EffDate TransactionDescription Amount Balance Beginning Balance......................................................................... 0.00,0.04,300.18
08/04,Deposit Home Banking Transfer From Share 10......................  REF# 62069205,140.00,140.00
08/08,Withdrawal Home Banking Transfer To Share 10....................  REF# 62191909,-75.00,65.00
08/10,Withdrawal Home Banking Transfer To Share 10....................  REF# 62237470,-65.00,0.00
08/11,Deposit Home Banking Transfer From Share 10......................  REF# 62265789,160.00,160.00
08/21,"Withdrawal Home Banking Transfer To Share 10....................  REF# 62562789 Ending Balance............................................................................. 75.00 YEAR-TO-DATE DIVIDEND SUMMARY Reportable Dividends this Year:............................................................................. 0.54 Reportable dividends of $10.00 or more are reported to the IRS as interest income for the year. ** The Visa Foreign Currency Transaction Fee will be assessed to purchases made outside of the United States as well as to online purchases made within the United States, but the merchant is located outside the United States. ** No-cost loan payment alternatives are available, please call 800-525-9623 for more information. Equal Housing Opportunity Ent is a registered trademark of Ent Credit Union Insured by NCUA 397914-1.58-51407N11.no7 029314349 7-7",-85.00,75.00
07/01,"Withdrawal Home Banking Transfer REF# 61038140..............  To HODGES,JUSTINE B 532694 Share 01",-170.00,"1,586.15"
07/03,"Withdrawal Home Banking Transfer REF# 61097741..............  To HODGES,JUSTINE B 532694 Share 10",-25.00,"1,561.15"
07/07,Deposit ACH UNIVERSITY OF CO............................................  TYPE: DIR DEP CO: UNIVERSITY OF CO,221.12,"1,782.27"
07/08,Withdrawal Home Banking Transfer To Share 10....................  REF# 61268088,-175.00,"1,607.27"
07/14,Deposit Home Banking Transfer From Share 10......................  REF# 61413949,75.00,"1,682.27"
07/21,Deposit ACH UNIVERSITY OF CO............................................  TYPE: DIR DEP CO: UNIVERSITY OF CO,178.92,"1,861.19"
07/22,"Withdrawal Home Banking Transfer REF# 61661367..............  To HODGES,JUSTINE B 532694 Share 00","-1,800.00",61.19
07/23,Withdrawal Home Banking Transfer To Share 10....................  Equal Housing Opportunity Ent is a registered trademark of Ent Credit Union Insured by NCUA AccountNumber 1159412 StatementPeriod07/01/23thru07/31/23 Page 2 of 11 Primary Savings - 00 PRIMARY SAVINGS (continued) TransDate EffDate TransactionDescription Amount Balance REF# 61688352,-30.00,31.19
07/24,Withdrawal Home Banking Transfer To Share 10....................  REF# 61703927,-25.00,6.19
07/31,"Deposit Dividend 0.050%........................................................  Annual Percentage Yield Earned 0.050% for period: 07/01/23 to 07/31/23 Ending Balance............................................................................. 6.24 No Strings Checking - 10 NO STRINGS CHECKING Dividends Earned YTD: 0.04 JointOwner:TYMITCHELL Beginning Balance + Deposits & Other Credits (21) - Checks Cleared (0) - Withdrawals & Other Debits (101)= Ending Balance $594.34 $6,309.23 $0.00 $6,753.15 $150.42 TransDate EffDate TransactionDescription Amount Balance Beginning Balance......................................................................... 594.34",0.05,6.24
07/01,Withdrawal POS #318218821934...........................................  COSTCO WHSE #1014 COLORADO SPRI CO 5300,-171.87,422.47
07/02,Withdrawal Debit Card Visa Check...........................................  TARGET 00022210 COLORADO SPRI CO 5411,-11.29,411.18
07/02,Recurring Withdrawal #318325103508...................................  Audible*KT1IM39F3 Amzn.com/bill NJ,-16.18,395.00
07/02,Withdrawal POS #318401362524...........................................  KING SOOPERS #01 9225 N COLORADO SPRI CO 5411,-60.86,334.14
07/03,Withdrawal Debit Card Visa Check...........................................  AMZN Mktp US*VG6HS94Z3 Amzn.com/bill WA 5942,-142.01,192.13
07/03,"Withdrawal Home Banking Transfer........................................  To HODGES,JUSTINE B 532694 Share 10 REF# 61100149 1/2 SOFTBALL",-60.00,132.13
07/03,Deposit Debit Card...................................................................  VENMO*Hodges Justine New York City NY Date 07/03/23 4829,63.87,196.00
07/04,Recurring Withdrawal Debit Card Visa Check..........................  APPLE.COM/BILL 866-712-7753 CA 5818,-0.99,195.01
07/04,Withdrawal Debit Card Visa Check...........................................  DUTCH BROS 541-955-4700 OR 5814,-15.00,180.01
07/05,Withdrawal POS #318609812490...........................................  KUM&GO 0659R CO SPRIN CO SPRINGS CO 5541,-7.46,172.55
07/05,Withdrawal Debit Card Visa Check...........................................  Equal Housing Opportunity Ent is a registered trademark of Ent Credit Union Insured by NCUA AccountNumber 1159412 StatementPeriod07/01/23thru07/31/23 Page 3 of 11 1111111111111111111111010011001100110111001110011000100010000001010000001110100011000011101011000110000001011100001100010011000011011000100110000000101011000100110010100111010111001010000100101111010100010011111011111011101011000111001111111101110011011010011100111010110011110010110011000010110001011111011111011000000111100101010001001100000010100101111110001100101000111100110000110000001101111110010110011111000111011011110011001100010111110010001000101010110101010101010101010101 No Strings Checking - 10 NO STRINGS CHECKING (continued) TransDate EffDate TransactionDescription Amount Balance STEAMGAMES.COM 42595229 425-8899642 WA 5816,-9.26,163.29
07/06,"Withdrawal Home Banking Transfer REF# 61198600..............  To HODGES,JUSTINE B 532694 Share 10",-60.00,103.29
07/07,Recurring Withdrawal Debit Card Visa Check..........................  COOKBOOK MOUNT COOLUM AU 5817,-1.49,101.80
07/07,Recurring Withdrawal Card Fee...............................................  VISA INTERNATIONAL SERVICE ASSESSMENT Date 07/07/23,-0.01,101.79
07/07,Deposit ACH UNIVERSITY OF CO............................................  TYPE: DIR DEP CO: UNIVERSITY OF CO,884.46,986.25
07/07,Withdrawal Debit Card Visa Check...........................................  DOMINOâ€™S 6246 COLORADO SPRI CO 5814,-28.91,957.34
07/07,Withdrawal Debit Card Visa Check...........................................  KUM&GO 0659R CO SPRIN CO SPRINGS CO 5542,-20.23,937.11
07/07,Withdrawal Debit Card Visa Check...........................................  VENMO* Visa Direct NY 4829,-15.00,922.11
07/07,Withdrawal Debit Card Visa Check...........................................  Amazon.com*KL5DY2UF3 Amzn.com/bill WA 5942,-14.34,907.77
07/07,Withdrawal Debit Card Visa Check...........................................  AMZN Mktp US*PM2AD45D3 Amzn.com/bill WA 5942,-41.33,866.44
07/08,Withdrawal Debit Card Visa Check...........................................  Amazon.com*E61OY2YA3 Amzn.com/bill WA 5942,-7.89,858.55
07/08,Withdrawal Home Banking Transfer To Share 11....................  REF# 61253231,-300.00,558.55
07/08,"Withdrawal Home Banking Transfer REF# 61253232..............  To HODGES,JUSTINE B 532694 Share 01",-100.00,458.55
07/08,"Withdrawal Home Banking Transfer REF# 61253233..............  To HODGES,JUSTINE B 532694 Share 10",-35.00,423.55
07/08,"Withdrawal Home Banking Transfer REF# 61253234..............  To HODGES,JUSTINE B 532694 Share 12 Equal Housing Opportunity Ent is a registered trademark of Ent Credit Union Insured by NCUA 391340-1.38-26008N11.no7 028700194 2-6 AccountNumber 1159412 StatementPeriod07/01/23thru07/31/23 Page 4 of 11 No Strings Checking - 10 NO STRINGS CHECKING (continued) TransDate EffDate TransactionDescription Amount Balance",-75.00,348.55
07/08,Withdrawal POS #318914056307...........................................  COSTCO WHSE #1014 COLORADO SPRI CO 5300,-166.96,181.59
07/08,Withdrawal Debit Card Visa Check...........................................  SQ *WORLD GOLF & SAND C Colorado Spri CO 5399,-12.00,169.59
07/08,Deposit Home Banking Transfer From Share 00......................  REF# 61268088,175.00,344.59
07/08,Withdrawal Debit Card Visa Check...........................................  VENMO* Visa Direct NY 4829,-16.00,328.59
07/09,Withdrawal Debit Card Visa Check...........................................  Amazon.com*BC5208OI3 Amzn.com/bill WA 5942,-139.82,188.77
07/09,Withdrawal POS #319018951826...........................................  KING SOOPERS #01 9225 N COLORADO SPRI CO 5411,-44.33,144.44
07/09,Withdrawal Debit Card Visa Check...........................................  ULTA #133 COLORADO SPRI CO 5977,-47.59,96.85
07/09,Withdrawal Debit Card Visa Check...........................................  RAISING CANES 0403 COLORADO SPRI CO 5814,-21.24,75.61
07/10,Recurring Withdrawal #319120743317...................................  ADOBE *CREATIVE CLOUD 408-536-6000 CA,-20.60,55.01
07/11,Withdrawal POS #319300810938...........................................  SEI 26292 825 NORTH NEVADA US COLORADO SPRI CO 5541,-5.92,49.09
07/11,Deposit Home Banking Transfer From Share 13......................  REF# 61344996,70.00,119.09
07/12,"07/11 Deposit Home Banking Transfer..............................................  From HODGES,JUSTINE B 532694 Loan 01 REF# 61350107 TV-PRIME DAY",640.00,759.09
07/12,Withdrawal Debit Card Visa Check...........................................  KUM&GO 0659R CO SPRIN CO SPRINGS CO 5542,-71.17,687.92
07/12,Withdrawal POS #319322134725...........................................  CIRCLE K 09847 COLORADO SPRN CO 5541,-4.77,683.15
07/13,Withdrawal POS #319408583001...........................................  KUM&GO 0659R CO SPRIN CO SPRINGS CO 5541,-7.46,675.69
07/13,Withdrawal Debit Card Visa Check...........................................  KUM&GO 0667R CO SPRIN CO SPRINGS CO 5542,-40.01,635.68
07/13,Withdrawal Debit Card Visa Check...........................................  Amazon.com*P86667JH3 Amzn.com/bill WA 5942,-32.73,602.95
07/13,Deposit Home Banking Transfer From Share 13......................  Equal Housing Opportunity Ent is a registered trademark of Ent Credit Union Insured by NCUA AccountNumber 1159412 StatementPeriod07/01/23thru07/31/23 Page 5 of 11 1111111111111111111111010011001100110001001110011000100010000001010000001110100011000011101011000110000001000100001100010011000011111000100110000000011011000100110010100100110111001010000100010011010100010011111001111111101011000111010111001101110011011011100011111010110011100101000001010010110000101001010111011000010001010000010001101111011011001101111111011101100111111100110001001101010011111000000011011000110111010011010011111100110111110100001000001011010101010101010101010101 No Strings Checking - 10 NO STRINGS CHECKING (continued) TransDate EffDate TransactionDescription Amount Balance REF# 61398823,40.00,642.95
07/14,Deposit ACH Colorado Springs................................................  TYPE: PR PAYMENT CO: Colorado Springs,"1,273.20","1,916.15"
07/14,Withdrawal Home Banking Transfer To Share 11....................  REF# 61413719,-300.00,"1,616.15"
07/14,Withdrawal Home Banking Transfer To Share 13....................  REF# 61413800,-140.00,"1,476.15"
07/14,"Withdrawal Home Banking Transfer REF# 61413828..............  To HODGES,JUSTINE B 532694 Share 11",-35.00,"1,441.15"
07/14,"Withdrawal Home Banking Transfer REF# 61413845..............  To HODGES,JUSTINE B 532694 Share 12",-125.00,"1,316.15"
07/14,"Withdrawal Home Banking Transfer REF# 61413857..............  To HODGES,JUSTINE B 532694 Share 01",-150.00,"1,166.15"
07/14,Withdrawal Home Banking Transfer To Share 00....................  REF# 61413949,-75.00,"1,091.15"
07/14,Withdrawal Debit Card Visa Check...........................................  VENMO* Visa Direct NY 4829,-8.00,"1,083.15"
07/14,"Deposit Home Banking Transfer REF# 61445217....................  From HODGES,JUSTINE B 532694 Share 10",500.00,"1,583.15"
07/14,Recurring Withdrawal Debit Card Visa Check..........................  APPLE.COM/BILL 866-712-7753 CA 5818,-15.99,"1,567.16"
07/14,Recurring Withdrawal Debit Card Visa Check..........................  APPLE.COM/BILL 866-712-7753 CA 5818,-0.99,"1,566.17"
07/14,Withdrawal POS #319523421450...........................................  DICKâ€™S SPORTING #322 COLORADO SPRI CO 5941,-81.12,"1,485.05"
07/15,Withdrawal Debit Card Visa Check...........................................  ZALES #1327 COLORADO SPRI CO 5944,-461.22,"1,023.83"
07/15,Withdrawal POS #319612401966...........................................  PETCO 1472 COLORADO SPRI CO 5995,-21.15,"1,002.68"
07/15,Withdrawal Debit Card Visa Check...........................................  Equal Housing Opportunity Ent is a registered trademark of Ent Credit Union Insured by NCUA 391340-1.38-26008N11.no7 028700194 3-6 AccountNumber 1159412 StatementPeriod07/01/23thru07/31/23 Page 6 of 11 No Strings Checking - 10 NO STRINGS CHECKING (continued) TransDate EffDate TransactionDescription Amount Balance IN N OUT BURGER 359 COLORADO SPRI CO 5814,-17.43,985.25
07/15,Withdrawal POS #319700737370...........................................  UNITED PACIFIC 6 10210 E ARAPAHOE R US CENTENNIAL CO 5541,-8.17,977.08
07/15,Withdrawal Debit Card Visa Check...........................................  TARGET 00022210 COLORADO SPRI CO 5411,-7.57,969.51
07/15,Withdrawal Debit Card Visa Check...........................................  VENMO* Visa Direct NY 4829,-10.00,959.51
07/16,Withdrawal Debit Card Visa Check...........................................  BUFF CITY SOAP - DUBLIN COLORADO SPRI CO 5099,-28.39,931.12
07/16,Withdrawal Debit Card Visa Check...........................................  RAISING CANES 0276 CASTLE ROCK CO 5814,-18.65,912.47
07/17,Withdrawal POS #319817883562...........................................  COSTCO WHSE #1014 COLORADO SPRI CO 5300,-58.64,853.83
07/17,Deposit Home Banking Transfer From Share 13......................  REF# 61523416,70.00,923.83
07/17,Withdrawal POS #319818782546...........................................  LOVELAND COUNTRY LOVELAND CO 5541,-9.58,914.25
07/17,Withdrawal POS #319900308695...........................................  KING SOOPERS #01 9225 N COLORADO SPRI CO 5411,-64.80,849.45
07/17,Withdrawal Debit Card Visa Check...........................................  PP*Emalie Atteberry LOVELAND CO 7230,-60.00,789.45
07/18,Withdrawal POS #319920854403...........................................  KUM&GO 0693R CO SPRINGS COLORADO SPRN CO 5541,-15.18,774.27
07/18,Withdrawal Debit Card Visa Check...........................................  Amazon.com*HX0KT2VO3 Amzn.com/bill WA 5942,-605.91,168.36
07/18,Withdrawal Debit Card Visa Check...........................................  DP DOUGH COLORADO SPRIN 678-787-9643 CO 5812,-4.43,163.93
07/20,"Deposit Home Banking Transfer REF# 61596534....................  From MITCHELL,JILLIAN 918043 Share 10 AMZN Mktp US Pending credit/return for $43.27 on card 0950",150.00,313.93
07/21,Withdrawal Adjustment Debit Card Credit Voucher.................  AMZN Mktp US Amzn.com/bill WA 5942,43.27,357.20
07/21,Deposit ACH UNIVERSITY OF CO............................................  Equal Housing Opportunity Ent is a registered trademark of Ent Credit Union Insured by NCUA AccountNumber 1159412 StatementPeriod07/01/23thru07/31/23 Page 7 of 11 1111111111111111111111010011001100110011001110011000100010010001010000001110100011000011101011000110000001110100001100010011000001011000100110000000101111000100110010100101010111001010000100001011010100010011111010100111101011000111110001111101110011011001000010111110110011100111110001000010110011011101110111011000101100001000010001001101000100110101111100101001010001011100111100010001111001111000000100101111001011011111010001100100100111110110001000101011010101010101010101010101 No Strings Checking - 10 NO STRINGS CHECKING (continued) TransDate EffDate TransactionDescription Amount Balance TYPE: DIR DEP CO: UNIVERSITY OF CO,715.67,"1,072.87"
07/21,Withdrawal POS #320200117131...........................................  KING SOOPERS #719 FUEL 9255 N UNION BL COLORADO SPRI CO 5542,-45.00,"1,027.87"
07/22,Withdrawal Debit Card Visa Check...........................................  SONIC DRIVE IN #5256 COLORADO SPRI CO 5814,-20.20,"1,007.67"
07/22,Withdrawal POS #320309559835...........................................  KUM&GO 0659R CO SPRIN CO SPRINGS CO 5541,-12.99,994.68
07/22,Withdrawal Home Banking Transfer To Share 11....................  REF# 61659217,-300.00,694.68
07/22,Withdrawal Home Banking Transfer To Share 13....................  REF# 61659225,-40.00,654.68
07/22,"Withdrawal Home Banking Transfer REF# 61659233..............  To HODGES,JUSTINE B 532694 Share 11",-35.00,619.68
07/22,"Withdrawal Home Banking Transfer REF# 61659278..............  To HODGES,JUSTINE B 532694 Share 01",-100.00,519.68
07/22,"Withdrawal Home Banking Transfer REF# 61659289..............  To HODGES,JUSTINE B 532694 Share 12",-100.00,419.68
07/22,Deposit Home Banking Transfer From Share 13......................  REF# 61666955,70.00,489.68
07/22,Withdrawal POS #320317649475...........................................  COSTCO WHSE #1014 COLORADO SPRI CO 5300,-2.15,487.53
07/22,Withdrawal POS #320317649940...........................................  COSTCO WHSE #1014 COLORADO SPRI CO 5300,-86.78,400.75
07/22,Withdrawal POS #320300015795...........................................  KING SOOPERS #0119 9225 N. UNION COLORADO SPRI CO 5411,-28.90,371.85
07/23,Deposit Home Banking Transfer From Share 13......................  REF# 61678441,70.00,441.85
07/23,Withdrawal Debit Card Visa Check...........................................  BOOTBARN.COM 888-440-2668 CA 5661,-309.66,132.19
07/23,Deposit Home Banking Transfer From Share 00......................  REF# 61688352,30.00,162.19
07/24,Withdrawal Debit Card Visa Check...........................................  Equal Housing Opportunity Ent is a registered trademark of Ent Credit Union Insured by NCUA 391340-1.38-26008N11.no7 028700194 4-6 AccountNumber 1159412 StatementPeriod07/01/23thru07/31/23 Page 8 of 11 No Strings Checking - 10 NO STRINGS CHECKING (continued) TransDate EffDate TransactionDescription Amount Balance AMZN Mktp US*2Q1TW26Q3 Amzn.com/bill WA 5942,-62.99,99.20
07/24,Withdrawal Debit Card Visa Check...........................................  MAVERIK #608 COLORADO SPRI CO 5541,-11.63,87.57
07/24,Withdrawal Debit Card Visa Check...........................................  MAVERIK #608 COLORADO SPRI CO 5542,-64.65,22.92
07/24,Withdrawal Debit Card Visa Check...........................................  PANDA EXPRESS #3558 FALCON CO 5814,-11.67,11.25
07/24,Deposit Home Banking Transfer From Share 00......................  REF# 61703927,25.00,36.25
07/24,Deposit Debit Card...................................................................  VENMO*Hodges Justine New York City NY Date 07/24/23 4829,10.25,46.50
07/24,Withdrawal Debit Card Visa Check...........................................  WL *Steam Purchase 425-9522985 WA 5816,-15.45,31.05
07/24,Withdrawal Debit Card Visa Check...........................................  WL *Steam Purchase 425-9522985 WA 5816,-15.45,15.60
07/25,Deposit Home Banking Transfer From Share 11......................  REF# 61745319,25.00,40.60
07/25,Withdrawal POS #320619764023...........................................  KUM&GO 0693R CO SPRINGS COLORADO SPRN CO 5541,-27.37,13.23
07/26,Withdrawal Debit Card Visa Check...........................................  MCDONALDâ€™S F26480 COLORADO SPRI CO 5814,-3.33,9.90
07/28,Deposit ACH Colorado Springs................................................  TYPE: PR PAYMENT CO: Colorado Springs,"1,253.49","1,263.39"
07/28,Withdrawal POS #320915852938...........................................  Boot Barn #85 Colorado Spri CO 5661,-18.38,"1,245.01"
07/28,Withdrawal Home Banking Transfer To Share 11....................  REF# 61834567,-300.00,945.01
07/28,Withdrawal POS #320900016991...........................................  KING SOOPERS #0119 9225 N. UNION COLORADO SPRI CO 5411,-44.22,900.79
07/28,Withdrawal Debit Card Visa Check...........................................  DP DOUGH COLORADO SPRIN 678-787-9643 CO 5812,-4.44,896.35
07/29,Withdrawal Debit Card Visa Check...........................................  THE UPS STORE 7267 719-3312719 CO 7399 Equal Housing Opportunity Ent is a registered trademark of Ent Credit Union Insured by NCUA AccountNumber 1159412 StatementPeriod07/01/23thru07/31/23 Page 9 of 11 1111111111111111111111010011001100110101001110011000100010000001010000001110100011000011101011000110000001101100001100010011000011111000100110000000110111000100110010100101010111001010000100101011010100010011111001000011101011000111101100001101110011011010101110111110110011011010000111010010110011110001111111011000100100000000110000001111111010011101111111000101110100011101000111110110011101111011001110101010010111010110010010100100010111110100001000001011110101010101010101010101 No Strings Checking - 10 NO STRINGS CHECKING (continued) TransDate EffDate TransactionDescription Amount Balance,-0.97,895.38
07/29,Withdrawal at ATM #000000008426.......................................  ENT CREDIT UNION 7339 DURYEA DRIVE COLORADO SPRI CO,-50.00,845.38
07/29,Withdrawal POS #321009774744...........................................  KUM&GO 0667R CO SPRIN CO SPRINGS CO 5541,-9.27,836.11
07/29,Withdrawal Debit Card Visa Check...........................................  AMZN Mktp US*TH2RI2JG2 Amzn.com/bill WA 5942,-0.28,835.83
07/29,Withdrawal Debit Card Visa Check...........................................  BOOTBARN.COM 888-440-2668 CA 5661,-281.31,554.52
07/29,Withdrawal POS #321016054584...........................................  EMPIRE 8155 COLORADO SPGS CO 5542,-72.19,482.33
07/29,Withdrawal POS #321022359840...........................................  Tan Your Hide #11 Colorado spri CO 7230,-44.95,437.38
07/30,Withdrawal POS #321113857428...........................................  MAVERIK #608 COLORADO SPRI CO 5542,-40.08,397.30
07/30,Deposit Home Banking Transfer From Share 11......................  REF# 61883097,200.00,597.30
07/30,Withdrawal POS #321116616214...........................................  COSTCO WHSE #1014 COLORADO SPRI CO 5300,-186.52,410.78
07/30,Withdrawal POS #321120358893...........................................  KING SOOPERS #01 9225 N COLORADO SPRI CO 5411,-6.98,403.80
07/30,Withdrawal Debit Card Visa Check...........................................  CALHAN SCHOOL DISTRICT CALHAN CO 8211,-10.00,393.80
07/31,Withdrawal Debit Card Visa Check...........................................  MAVERIK #608 COLORADO SPRI CO 5541 BOOTBARN.COM Pending credit/return for $309.66 on card 0950,-8.40,385.40
07/31,"Withdrawal Home Banking Transfer REF# 61926184..............  To HODGES,JUSTINE B 532694 Share 01",-100.00,285.40
07/31,"Withdrawal Home Banking Transfer REF# 61926199..............  To HODGES,JUSTINE B 532694 Share 12",-100.00,185.40
07/31,"Withdrawal Home Banking Transfer REF# 61926212..............  To HODGES,JUSTINE B 532694 Share 11",-35.00,150.40
07/31,"Deposit Dividend Tiered Rate..................................................  Annual Percentage Yield Earned 0.060% for period: 07/01/23 to 07/31/23 Ending Balance............................................................................. 150.42 Equal Housing Opportunity Ent is a registered trademark of Ent Credit Union Insured by NCUA 391340-1.38-26008N11.no7 028700194 5-6 AccountNumber 1159412 StatementPeriod07/01/23thru07/31/23 Page 10 of 11 No Strings Checking - 11 NO STRINGS CHECKING Dividends Earned YTD: 0.14 JointOwner:TYMITCHELL Beginning Balance + Deposits & Other Credits (6) - Checks Cleared (0) - Withdrawals & Other Debits (3) = Ending Balance $300.11 $1,225.03 $0.00 $1,425.00 $100.14 TransDate EffDate TransactionDescription Amount Balance Beginning Balance......................................................................... 300.11",0.02,150.42
07/08,Deposit Home Banking Transfer From Share 10......................  REF# 61253231,300.00,600.11
07/14,Deposit Home Banking Transfer From Share 10......................  REF# 61413719,300.00,900.11
07/22,Deposit Home Banking Transfer From Share 10......................  REF# 61659217,300.00,"1,200.11"
07/25,Withdrawal Home Banking Transfer To Share 10....................  REF# 61745319,-25.00,"1,175.11"
07/25,"Deposit Home Banking Transfer REF# 61745338....................  From HODGES,JUSTINE B 532694 Share 10",25.00,"1,200.11"
07/28,Deposit Home Banking Transfer From Share 10......................  REF# 61834567,300.00,"1,500.11"
07/30,Withdrawal Home Banking Transfer To Share 10....................  REF# 61883097,-200.00,"1,300.11"
07/31,Withdrawal Home Banking......................................................  ACH WITHDRAWAL US BANK NA - JUSTINE HODGES,"-1,200.00",100.11
07/31,Deposit Dividend Tiered Rate..................................................  Annual Percentage Yield Earned 0.040% for period: 07/01/23 to 07/31/23 Ending Balance............................................................................. 100.14 No Strings Checking - 12 NO STRINGS CHECKING Dividends Earned YTD: 0.01 JointOwner:TYMITCHELL Beginning Balance + Deposits & Other Credits (0) - Checks Cleared (0) - Withdrawals & Other Debits (0) = Ending Balance $0.00 $0.00 $0.00 $0.00 $0.00 TransDate EffDate TransactionDescription Amount Balance Beginning Balance......................................................................... 0.00 Ending Balance............................................................................. 0.00 Equal Housing Opportunity Ent is a registered trademark of Ent Credit Union Insured by NCUA AccountNumber 1159412 StatementPeriod07/01/23thru07/31/23 Page 11 of 11 1111111111111111111111010001001100110111001110011000100010010001010000001110100011000011101011000110000001101100001100010011000000111000100110000000101111000100110010100111010111001010000100101001010100010011111001111111101011000111000000011100110011011001000101111010110011010110010111000010110011100000111111011000011111001011110001101101101010100111111001010000100100010101100010010101010011011010110110110000010111011010010001000100010111110010111001101011110101010101010101010101 No Strings Checking - 13 NO STRINGS CHECKING Dividends Earned YTD: 0.01 JointOwner:TYMITCHELL Beginning Balance + Deposits & Other Credits (2) - Checks Cleared (0) - Withdrawals & Other Debits (5) = Ending Balance $140.00 $180.00 $0.00 $320.00 $0.00 TransDate EffDate TransactionDescription Amount Balance Beginning Balance......................................................................... 140.00,0.03,100.14
07/11,Withdrawal Home Banking Transfer To Share 10....................  REF# 61344996,-70.00,70.00
07/13,Withdrawal Home Banking Transfer To Share 10....................  REF# 61398823,-40.00,30.00
07/14,Deposit Home Banking Transfer From Share 10......................  REF# 61413800,140.00,170.00
07/17,Withdrawal Home Banking Transfer To Share 10....................  REF# 61523416,-70.00,100.00
07/22,Deposit Home Banking Transfer From Share 10......................  REF# 61659225,40.00,140.00
07/22,Withdrawal Home Banking Transfer To Share 10....................  REF# 61666955,-70.00,70.00
07/23,"Withdrawal Home Banking Transfer To Share 10....................  REF# 61678441 Ending Balance............................................................................. 0.00 YEAR-TO-DATE DIVIDEND SUMMARY Reportable Dividends this Year:............................................................................. 0.46 Reportable dividends of $10.00 or more are reported to the IRS as interest income for the year. ** The Visa Foreign Currency Transaction Fee will be assessed to purchases made outside of the United States as well as to online purchases made within the United States, but the merchant is located outside the United States. ** No-cost loan payment alternatives are available, please call 800-525-9623 for more information. Equal Housing Opportunity Ent is a registered trademark of Ent Credit Union Insured by NCUA 391340-1.38-26008N11.no7 028700194 6-6",-70.00,0.00
06/02,Deposit ACH Colorado Springs................................................  TYPE: PR PAYMENT CO: Colorado Springs,138.06,"1,455.31"
06/09,Deposit ACH UNIVERSITY OF CO............................................  TYPE: DIR DEP CO: UNIVERSITY OF CO,156.89,"1,612.20"
06/13,Withdrawal Home Banking Transfer To Share 10....................  REF# 60496111,-130.00,"1,482.20"
06/13,Deposit Home Banking Transfer From Share 10......................  REF# 60496214,130.00,"1,612.20"
06/16,Deposit ACH Colorado Springs................................................  TYPE: PR PAYMENT CO: Colorado Springs,127.32,"1,739.52"
06/16,Withdrawal at ATM #000000007995.......................................  ENT CREDIT UNION 7020 CAMPUS DRIVE COLORADO SPRI CO,-120.00,"1,619.52"
06/19,Withdrawal Home Banking Transfer To Share 10....................  REF# 60676648,-190.00,"1,429.52"
06/23,Deposit ACH UNIVERSITY OF CO............................................  Equal Housing Opportunity Ent is a registered trademark of Ent Credit Union Insured by NCUA AccountNumber 1159412 StatementPeriod06/01/23thru06/30/23 Page 2 of 10 Primary Savings - 00 PRIMARY SAVINGS (continued) TransDate EffDate TransactionDescription Amount Balance TYPE: DIR DEP CO: UNIVERSITY OF CO,225.15,"1,654.67"
06/29,"Withdrawal Home Banking Transfer REF# 60946832..............  To HODGES,JUSTINE B 532694 Share 01",-35.00,"1,619.67"
06/30,Deposit ACH Colorado Springs................................................  TYPE: PR PAYMENT CO: Colorado Springs,136.42,"1,756.09"
06/30,"Deposit Dividend 0.050%........................................................  Annual Percentage Yield Earned 0.050% for period: 06/01/23 to 06/30/23 Ending Balance............................................................................. 1,756.15 No Strings Checking - 10 NO STRINGS CHECKING Dividends Earned YTD: 0.02 JointOwner:TYMITCHELL Beginning Balance + Deposits & Other Credits (15) - Checks Cleared (0) - Withdrawals & Other Debits (91) = Ending Balance $13.02 $6,084.47 $0.00 $5,503.15 $594.34 TransDate EffDate TransactionDescription Amount Balance Beginning Balance......................................................................... 13.02",0.06,"1,756.15"
06/02,Deposit ACH Colorado Springs................................................  TYPE: PR PAYMENT CO: Colorado Springs,"1,242.61","1,255.63"
06/02,Withdrawal Home Banking Transfer To Share 11....................  REF# 60167147,-300.00,955.63
06/02,Withdrawal Home Banking Transfer To Share 12....................  REF# 60167157,-200.00,755.63
06/02,Withdrawal Home Banking Transfer To Share 13....................  REF# 60167167,-100.00,655.63
06/02,"Withdrawal Home Banking Transfer........................................  To HODGES,JUSTINE B 532694 Share 01 REF# 60167184 CREDIT LOAN",-50.00,605.63
06/02,"Withdrawal Home Banking Transfer........................................  To HODGES,JUSTINE B 532694 Share 10 REF# 60167200 1/2 VILLA",-70.00,535.63
06/02,"Withdrawal Home Banking Transfer REF# 60167223..............  To HODGES,JUSTINE B 532694 Share 11",-50.00,485.63
06/02,"Withdrawal Home Banking Transfer........................................  To HODGES,JUSTINE B 532694 Share 12 REF# 60167247 CAR PMT",-150.00,335.63
06/02,"Withdrawal Home Banking Transfer........................................  To HODGES,JUSTINE B 532694 Share 01 REF# 60167261 TY LOAN Equal Housing Opportunity Ent is a registered trademark of Ent Credit Union Insured by NCUA AccountNumber 1159412 StatementPeriod06/01/23thru06/30/23 Page 3 of 10 1111111111111111111111010011001100110111001110011000100010000001010000000100100011000011101011101010000001011100001100010011000001111000101110000000100111000100000010100110110111001010000100011111010110000011111001111111100111000111001111101101010001011001010111111010111011011101100011000100110001100111010111010000011101011011110000011100001100000111110110000010101011001100001111011101000011111110000111110100100011011111110001100100100110100110001001001010110101010101010101010101 No Strings Checking - 10 NO STRINGS CHECKING (continued) TransDate EffDate TransactionDescription Amount Balance",-50.00,285.63
06/02,Deposit Home Banking Transfer From Share 13......................  REF# 60182570,70.00,355.63
06/02,Withdrawal #315314872552...................................................  8667127753 APPLE COM BILL CUPERTINO CA,-5.99,349.64
06/02,Recurring Withdrawal #315314872681...................................  8667127753 APPLE COM BILL CUPERTINO CA,-0.99,348.65
06/03,Withdrawal Debit Card Visa Check...........................................  2574PEPSIVEN9147678600 COLORADO SPRI CO 5814,-2.25,346.40
06/03,"Withdrawal Home Banking Transfer REF# 60226981..............  To HODGES,JUSTINE B 532694 Share 10",-65.00,281.40
06/03,Withdrawal POS #315416655923...........................................  PETCO 1472 COLORADO SPRI CO 5995,-44.32,237.08
06/03,Withdrawal Debit Card Visa Check...........................................  REGAL CINEMAS INC 865-922-1123 TN 7832,-30.76,206.32
06/04,Withdrawal Debit Card Visa Check...........................................  LEVELUPSMOOTHIEKING36 855-466-5585 MA 5812,-11.34,194.98
06/04,Deposit Home Banking Transfer From Share 12......................  REF# 60242600,200.00,394.98
06/04,Withdrawal POS #315512616204...........................................  KUM&GO 0658R CO SPRIN CO SPRINGS CO 5541,-13.51,381.47
06/04,Withdrawal POS #315513690790...........................................  COSTCO WHSE #1014 COLORADO SPRI CO 5300,-211.48,169.99
06/04,Withdrawal POS #315515759077...........................................  KUM&GO 0667R CO SPRIN CO SPRINGS CO 5541,-4.39,165.60
06/04,Withdrawal POS #315519916573...........................................  KING SOOPERS #01 9225 N COLORADO SPRI CO 5411,-58.60,107.00
06/05,Withdrawal Debit Card Visa Check...........................................  AMZN Mktp US*U40FF5PY3 Amzn.com/bill WA 5942,-31.10,75.90
06/06,Deposit Home Banking Transfer From Share 13......................  REF# 60316414,59.00,134.90
06/07,Recurring Withdrawal Debit Card Visa Check..........................  COOKBOOK MOUNT COOLUM AU 5734,-1.49,133.41
06/07,Recurring Withdrawal Card Fee...............................................  VISA INTERNATIONAL SERVICE ASSESSMENT Equal Housing Opportunity Ent is a registered trademark of Ent Credit Union Insured by NCUA 382639-1.44-09224N11.no8 028070806 2-5 AccountNumber 1159412 StatementPeriod06/01/23thru06/30/23 Page 4 of 10 No Strings Checking - 10 NO STRINGS CHECKING (continued) TransDate EffDate TransactionDescription Amount Balance Date 06/07/23,-0.01,133.40
06/07,Withdrawal Debit Card Visa Check...........................................  KUM&GO 0659R CO SPRIN CO SPRINGS CO 5542,-59.00,74.40
06/09,Withdrawal Debit Card Visa Check...........................................  LEVELUPSMOOTHIEKING94 855-466-5585 MA 5812,-17.19,57.21
06/09,Deposit ACH UNIVERSITY OF CO............................................  TYPE: DIR DEP CO: UNIVERSITY OF CO,627.55,684.76
06/09,Withdrawal POS #316100558179...........................................  KING SOOPERS #01 9225 N COLORADO SPRI CO 5411,-79.00,605.76
06/10,Recurring Withdrawal #316120713786...................................  ADOBE *CREATIVE CLOUD 408-536-6000 CA,-20.60,585.16
06/10,Withdrawal POS #316200739568...........................................  KING SOOPERS #01 9225 N COLORADO SPRI CO 5411,-31.61,553.55
06/11,Withdrawal Debit Card Visa Check...........................................  Blizzard US674129852 194-99551380 CA 5816,-69.99,483.56
06/11,Withdrawal Home Banking Transfer To Share 11....................  REF# 60443674,-300.00,183.56
06/11,Withdrawal Debit Card Visa Check...........................................  AMZN Mktp US*999R61U03 Amzn.com/bill WA 5942,-21.35,162.21
06/11,Withdrawal Debit Card Visa Check...........................................  AMZN Mktp US*WF5UK3283 Amzn.com/bill WA 5942,-20.77,141.44
06/12,Withdrawal POS #316308958038...........................................  KUM&GO 0659R CO SPRIN CO SPRINGS CO 5541,-8.31,133.13
06/13,Withdrawal Debit Card Visa Check...........................................  MARCOS PIZZA - 6009 COLORADO SPRI CO 5812,-25.50,107.63
06/13,Deposit Home Banking Transfer From Share 00......................  REF# 60496111,130.00,237.63
06/13,Withdrawal Home Banking Transfer To Share 00....................  REF# 60496214,-130.00,107.63
06/14,Recurring Withdrawal #316503925247...................................  8667127753 APPLE COM BILL CUPERTINO CA,-0.99,106.64
06/14,Withdrawal Debit Card Visa Check...........................................  UCCS PARKING ONLINE PYM 719-255-3528 CO 8220,-32.50,74.14
06/15,Withdrawal POS #316608746799...........................................  KUM&GO 0659R CO SPRIN CO SPRINGS CO 5541,-7.92,66.22
06/15,Withdrawal #316620692007...................................................  Equal Housing Opportunity Ent is a registered trademark of Ent Credit Union Insured by NCUA AccountNumber 1159412 StatementPeriod06/01/23thru06/30/23 Page 5 of 10 1111111111111111111111010011001100110001001110011000100010000001010000000100100011000011101011101010000001000100001100010011000001011000101110000000010111000100000010100101010111001010000100100011010110000011111011111011100111000111010111011101010001011000101000111010111011001010010001010100110000010001011111010000001011101110110000111111010101101111110111010011100100001100001110100000011101111000010010110011010011010111010001010100000110100000001001101011010101010101010101010101 No Strings Checking - 10 NO STRINGS CHECKING (continued) TransDate EffDate TransactionDescription Amount Balance 8667127753 APPLE COM BILL CUPERTINO CA,-21.98,44.24
06/15,Withdrawal Debit Card Visa Check...........................................  LEVELUPSMOOTHIEKING73 855-466-5585 MA 5812,-14.08,30.16
06/16,Deposit ACH Colorado Springs................................................  TYPE: PR PAYMENT CO: Colorado Springs,"1,145.88","1,176.04"
06/16,Withdrawal Home Banking Transfer To Share 11....................  REF# 60592853,-300.00,876.04
06/16,Withdrawal POS #316710071598...........................................  MAVERIK #673 COLORADO SPRI CO 5542,-61.99,814.05
06/16,Withdrawal Home Banking Transfer To Share 13....................  REF# 60593528,-90.00,724.05
06/16,"Withdrawal Home Banking Transfer REF# 60593541..............  To HODGES,JUSTINE B 532694 Share 10",-35.00,689.05
06/16,"Withdrawal Home Banking Transfer REF# 60593557..............  To HODGES,JUSTINE B 532694 Share 12",-100.00,589.05
06/16,"Withdrawal Home Banking Transfer REF# 60593565..............  To HODGES,JUSTINE B 532694 Share 01",-100.00,489.05
06/16,"Withdrawal Home Banking Transfer REF# 60593585..............  To HODGES,JUSTINE B 532694 Share 11",-50.00,439.05
06/16,Withdrawal POS #316712240060...........................................  LOWEâ€™S #2806 701 N ACADEMY BLVD COLORADOSPRIN CO 5200,-2.90,436.15
06/16,Withdrawal Debit Card Visa Check...........................................  SQ *THE9THFLOOR CONCIER Colorado Spri CO 5814,-3.50,432.65
06/16,Withdrawal POS #316700117594...........................................  KING SOOPERS #719 FUEL 9255 N UNION BL COLORADO SPRI CO 5542,-60.84,371.81
06/16,Withdrawal POS #316800641323...........................................  KING SOOPERS #01 9225 N COLORADO SPRI CO 5411,-46.23,325.58
06/17,Withdrawal POS #316818058734...........................................  COSTCO WHSE #1014 COLORADO SPRI CO 5300,-140.05,185.53
06/18,Withdrawal POS #316915040942...........................................  KING SOOPERS #01 9225 N COLORADO SPRI CO 5411,-4.10,181.43
06/18,Withdrawal POS #316911153172...........................................  Equal Housing Opportunity Ent is a registered trademark of Ent Credit Union Insured by NCUA 382639-1.44-09224N11.no8 028070806 3-5 AccountNumber 1159412 StatementPeriod06/01/23thru06/30/23 Page 6 of 10 No Strings Checking - 10 NO STRINGS CHECKING (continued) TransDate EffDate TransactionDescription Amount Balance SAFEWAY #4615 FALCON CO 5411,-10.27,171.16
06/18,Withdrawal Debit Card Visa Check...........................................  STAG TOBACCONIST COLORADO SPRI CO 5993,-27.56,143.60
06/19,Deposit Home Banking Transfer From Share 13......................  REF# 60673076,96.01,239.61
06/19,"Deposit Home Banking Transfer..............................................  From HODGES,JUSTINE B 532694 Loan 01 REF# 60676622 BARKBOX",100.00,339.61
06/19,Deposit Home Banking Transfer From Share 00......................  REF# 60676648,190.00,529.61
06/19,Recurring Withdrawal #317025745220...................................  BARK&CO (BARKBOX) 855-338-2275 NY,-28.64,500.97
06/20,Withdrawal Debit Card Visa Check...........................................  CHIPOTLE 0067 COLORADO SPRI CO 5814,-12.55,488.42
06/20,Recurring Withdrawal #317124745248...................................  BARK&CO (BARKBOX) 855-338-2275 NY,-211.05,277.37
06/20,"Withdrawal Home Banking Transfer REF# 60691845..............  To HODGES,JUSTINE B 532694 Share 01",-100.00,177.37
06/21,Withdrawal Debit Card Visa Check...........................................  AMZN Mktp US*UP5D23XY3 Amzn.com/bill WA 5942,-92.22,85.15
06/21,Withdrawal POS #317300420487...........................................  KING SOOPERS #01 9225 N COLORADO SPRI CO 5411,-3.29,81.86
06/22,Withdrawal Debit Card Visa Check...........................................  2574PEPSIVEN9147678600 COLORADO SPRI CO 5814,-2.25,79.61
06/23,Deposit ACH UNIVERSITY OF CO............................................  TYPE: DIR DEP CO: UNIVERSITY OF CO,900.61,980.22
06/23,Withdrawal Home Banking Transfer To Share 11....................  REF# 60802014,-300.00,680.22
06/23,"Withdrawal Home Banking Transfer REF# 60802015..............  To HODGES,JUSTINE B 532694 Share 10",-35.00,645.22
06/23,Withdrawal Home Banking Transfer To Share 13....................  REF# 60802018,-70.00,575.22
06/23,"Withdrawal Home Banking Transfer REF# 60802168..............  To HODGES,JUSTINE B 532694 Share 12",-50.00,525.22
06/23,"Withdrawal Home Banking Transfer REF# 60802187..............  Equal Housing Opportunity Ent is a registered trademark of Ent Credit Union Insured by NCUA AccountNumber 1159412 StatementPeriod06/01/23thru06/30/23 Page 7 of 10 1111111111111111111111010011001100110011001110011000100010010001010000000100100011000011101011101010000001110100001100010011000011111000101110000000100011000100000010100100110111001010000100111011010110000011111000100011100111000111110001101101010001011010001001111110111011001000100001000100110011100101111111010000110110110110110000011101001010010111110100100111010010101100000011111100110111111000010101000100101111011011010011001100010110100010001001001011010101010101010101010101 No Strings Checking - 10 NO STRINGS CHECKING (continued) TransDate EffDate TransactionDescription Amount Balance To HODGES,JUSTINE B 532694 Share 01",-50.00,475.22
06/23,"Withdrawal Home Banking Transfer REF# 60802206..............  To HODGES,JUSTINE B 532694 Share 11",-75.00,400.22
06/23,Withdrawal POS #317500661638...........................................  KING SOOPERS #01 9225 N COLORADO SPRI CO 5411,-2.49,397.73
06/24,Withdrawal Debit Card Visa Check...........................................  Amazon.com*004NS51Z3 Amzn.com/bill WA 5942,-11.11,386.62
06/24,Withdrawal Debit Card Visa Check...........................................  TARGET 00022210 COLORADO SPRI CO 5411,-24.56,362.06
06/25,Withdrawal Debit Card Visa Check...........................................  MAVERIK #608 COLORADO SPRI CO 5541,-11.64,350.42
06/25,Withdrawal Debit Card Visa Check...........................................  MAVERIK #608 COLORADO SPRI CO 5542,-59.59,290.83
06/25,Withdrawal Debit Card Visa Check...........................................  LEVELUPSMOOTHIEKING68 855-466-5585 MA 5812,-10.34,280.49
06/25,Withdrawal Debit Card Visa Check...........................................  PANDA EXPRESS #3558 FALCON CO 5814,-11.67,268.82
06/25,Withdrawal POS #317614750282...........................................  KUM&GO 0659R CO SPRIN CO SPRINGS CO 5541,-22.67,246.15
06/26,Withdrawal Debit Card Visa Check...........................................  LEVELUPSMOOTHIEKING39 855-466-5585 MA 5812,-16.05,230.10
06/26,Withdrawal Debit Card Visa Check...........................................  CHEBA HUT- COLORADO SPR COLORADO SPRI CO 5812,-25.00,205.10
06/26,Withdrawal Debit Card Visa Check...........................................  SQ *K BARBER NEXT LEVEL Colorado Spri CO 7230,-37.50,167.60
06/27,Withdrawal POS #317808575680...........................................  KUM&GO 0659R CO SPRIN CO SPRINGS CO 5541,-6.23,161.37
06/27,Deposit Home Banking Transfer From Share 13......................  REF# 60893870,30.00,191.37
06/27,Withdrawal POS #317814487879...........................................  COSTCO WHSE #1014 COLORADO SPRI CO 5300,-117.29,74.08
06/27,Withdrawal POS #317818929022...........................................  KING SOOPERS #01 9225 N COLORADO SPRI CO Equal Housing Opportunity Ent is a registered trademark of Ent Credit Union Insured by NCUA 382639-1.44-09224N11.no8 028070806 4-5 AccountNumber 1159412 StatementPeriod06/01/23thru06/30/23 Page 8 of 10 No Strings Checking - 10 NO STRINGS CHECKING (continued) TransDate EffDate TransactionDescription Amount Balance 5411,-34.89,39.19
06/28,Withdrawal Debit Card Visa Check...........................................  DP DOUGH COLORADO SPRIN COLORADO SPRI CO 5812,-4.43,34.76
06/28,Withdrawal Debit Card Visa Check...........................................  AMZN Mktp US*7A04G73N3 Amzn.com/bill WA 5942,-7.45,27.31
06/28,Deposit Home Banking Transfer From Share 13......................  REF# 60934239,65.00,92.31
06/29,Withdrawal Debit Card Visa Check...........................................  KUM&GO 0659R CO SPRIN CO SPRINGS CO 5542,-62.17,30.14
06/29,Withdrawal POS #318017276368...........................................  CIRCLE K # 40693 COLORADO SPRI CO 5541,-3.25,26.89
06/30,Withdrawal Debit Card Visa Check...........................................  CIRCLE K # 40693 COLORADO SPRI CO 5542,-20.36,6.53
06/30,Deposit ACH Colorado Springs................................................  TYPE: PR PAYMENT CO: Colorado Springs,"1,227.80","1,234.33"
06/30,Withdrawal Home Banking Transfer To Share 11....................  REF# 60990286,-300.00,934.33
06/30,Withdrawal Home Banking Transfer To Share 13....................  REF# 60990370,-105.00,829.33
06/30,"Withdrawal Home Banking Transfer REF# 60990395..............  To HODGES,JUSTINE B 532694 Share 12",-100.00,729.33
06/30,"Withdrawal Home Banking Transfer REF# 60990444..............  To HODGES,JUSTINE B 532694 Share 01",-100.00,629.33
06/30,"Withdrawal Home Banking Transfer REF# 60990468..............  To HODGES,JUSTINE B 532694 Share 10",-35.00,594.33
06/30,"Deposit Dividend Tiered Rate..................................................  Annual Percentage Yield Earned 0.060% for period: 06/01/23 to 06/30/23 Ending Balance............................................................................. 594.34 No Strings Checking - 11 NO STRINGS CHECKING Dividends Earned YTD: 0.11 JointOwner:TYMITCHELL Beginning Balance + Deposits & Other Credits (6) - Checks Cleared (0) - Withdrawals & Other Debits (1) = Ending Balance $0.08 $1,500.03 $0.00 $1,200.00 $300.11 TransDate EffDate TransactionDescription Amount Balance Beginning Balance......................................................................... 0.08",0.01,594.34
06/02,Deposit Home Banking Transfer From Share 10......................  Equal Housing Opportunity Ent is a registered trademark of Ent Credit Union Insured by NCUA AccountNumber 1159412 StatementPeriod06/01/23thru06/30/23 Page 9 of 10 1111111111111111111111010001001100110101001110011000100010000001010000000100100011000011101011101010000001101100001100010011000001111000101110000000010001000100000010100100010111001010000100001011010110000011111000110111100111000111000011011101010001011011010011111110111011010011000101010100110010001001000111010000101111110011010000111101001010111111110010111111110100101100101101010101001000111000000001010000111111011101110000001100000110100100111000101011110101010101010101010101 No Strings Checking - 11 NO STRINGS CHECKING (continued) TransDate EffDate TransactionDescription Amount Balance REF# 60167147,300.00,300.08
06/11,Deposit Home Banking Transfer From Share 10......................  REF# 60443674,300.00,600.08
06/16,Deposit Home Banking Transfer From Share 10......................  REF# 60592853,300.00,900.08
06/23,Deposit Home Banking Transfer From Share 10......................  REF# 60802014,300.00,"1,200.08"
06/30,Deposit Home Banking Transfer From Share 10......................  REF# 60990286,300.00,"1,500.08"
06/30,Withdrawal Home Banking......................................................  ACH WITHDRAWAL US BANK NA - JUSTINE HODGES,"-1,200.00",300.08
06/30,Deposit Dividend Tiered Rate..................................................  Annual Percentage Yield Earned 0.050% for period: 06/01/23 to 06/30/23 Ending Balance............................................................................. 300.11 No Strings Checking - 12 NO STRINGS CHECKING Dividends Earned YTD: 0.01 JointOwner:TYMITCHELL Beginning Balance + Deposits & Other Credits (1) - Checks Cleared (0) - Withdrawals & Other Debits (1) = Ending Balance $0.00 $200.00 $0.00 $200.00 $0.00 TransDate EffDate TransactionDescription Amount Balance Beginning Balance......................................................................... 0.00,0.03,300.11
06/02,Deposit Home Banking Transfer From Share 10......................  REF# 60167157,200.00,200.00
06/04,Withdrawal Home Banking Transfer To Share 10....................  REF# 60242600 Ending Balance............................................................................. 0.00 No Strings Checking - 13 NO STRINGS CHECKING Dividends Earned YTD: 0.01 JointOwner:TYMITCHELL Beginning Balance + Deposits & Other Credits (4) - Checks Cleared (0) - Withdrawals & Other Debits (5) = Ending Balance $95.01 $365.00 $0.00 $320.01 $140.00 TransDate EffDate TransactionDescription Amount Balance Beginning Balance......................................................................... 95.01,-200.00,0.00
06/02,Deposit Home Banking Transfer From Share 10......................  Equal Housing Opportunity Ent is a registered trademark of Ent Credit Union Insured by NCUA 382639-1.44-09224N11.no8 028070806 5-5 AccountNumber 1159412 StatementPeriod06/01/23thru06/30/23 Page 10 of 10 No Strings Checking - 13 NO STRINGS CHECKING (continued) TransDate EffDate TransactionDescription Amount Balance REF# 60167167,100.00,195.01
06/02,Withdrawal Home Banking Transfer To Share 10....................  REF# 60182570,-70.00,125.01
06/06,Withdrawal Home Banking Transfer To Share 10....................  REF# 60316414,-59.00,66.01
06/16,Deposit Home Banking Transfer From Share 10......................  REF# 60593528,90.00,156.01
06/19,Withdrawal Home Banking Transfer To Share 10....................  REF# 60673076,-96.01,60.00
06/23,Deposit Home Banking Transfer From Share 10......................  REF# 60802018,70.00,130.00
06/27,Withdrawal Home Banking Transfer To Share 10....................  REF# 60893870,-30.00,100.00
06/28,Withdrawal Home Banking Transfer To Share 10....................  REF# 60934239,-65.00,35.00
06/30,"Deposit Home Banking Transfer From Share 10......................  REF# 60990370 Ending Balance............................................................................. 140.00 YEAR-TO-DATE DIVIDEND SUMMARY Reportable Dividends this Year:............................................................................. 0.36 Reportable dividends of $10.00 or more are reported to the IRS as interest income for the year. ** The Visa Foreign Currency Transaction Fee will be assessed to purchases made outside of the United States as well as to online purchases made within the United States, but the merchant is located outside the United States. ** No-cost loan payment alternatives are available, please call 800-525-9623 for more information. Equal Housing Opportunity Ent is a registered trademark of Ent Credit Union Insured by NCUA",105.00,140.00
03/27,"Deposit Transfer......................................................................  From MITCHELL,TY 894616 Share 00",488.79,488.79
03/27,"Deposit Transfer......................................................................  From HODGES,JUSTINE B 532694 Share 00","1,146.46","1,635.25"
03/31,"Deposit Dividend 0.050%........................................................  Annual Percentage Yield Earned 0.040% for period: 03/27/23 to 03/31/23 Ending Balance............................................................................. 1,635.26 No Strings Checking - 10 NO STRINGS CHECKING Dividends Earned YTD: 0.00 JointOwner:TYMITCHELL Beginning Balance + Deposits & Other Credits (2) - Checks Cleared (0) - Withdrawals & Other Debits (3) = Ending Balance $0.00 $1,150.00 $0.00 $35.61 $1,114.39 TransDate EffDate TransactionDescription Amount Balance Beginning Balance......................................................................... 0.00",0.01,"1,635.26"
03/27,"Deposit Home Banking Transfer REF# 58190038....................  From HODGES,JUSTINE B 532694 Share 10",400.00,400.00
03/28,Withdrawal POS #308700004103...........................................  LITTLE CAESARS 3356-0001 4535 AUSTIN Equal Housing Opportunity Ent is a registered trademark of Ent Credit Union Insured by NCUA AccountNumber 1159412 StatementPeriod03/27/23thru03/31/23 Page 2 of 3 No Strings Checking - 10 NO STRINGS CHECKING (continued) TransDate EffDate TransactionDescription Amount Balance BLUFFS PARK COLORADO SPRI CO 5814,-17.82,382.18
03/29,Withdrawal POS #308809777019...........................................  KUM&GO 0689 CO SPRIN CO SPRINGS CO 5541,-11.37,370.81
03/31,"Deposit Home Banking Transfer REF# 58315573....................  From HODGES,JUSTINE B 532694 Share 10",750.00,"1,120.81"
03/31,"Withdrawal POS #309020857760...........................................  KUM&GO 0667R CO SPRIN CO SPRINGS CO 5541 Ending Balance............................................................................. 1,114.39 No Strings Checking - 11 NO STRINGS CHECKING Dividends Earned YTD: 0.01 JointOwner:TYMITCHELL Beginning Balance + Deposits & Other Credits (3) - Checks Cleared (0) - Withdrawals & Other Debits (1) = Ending Balance $0.00 $1,040.01 $0.00 $1,040.00 $0.01 TransDate EffDate TransactionDescription Amount Balance Beginning Balance......................................................................... 0.00",-6.42,"1,114.39"
03/27,"Deposit Home Banking Transfer REF# 58189689....................  From HODGES,JUSTINE B 532694 Share 01","1,000.00","1,000.00"
03/27,"Deposit Home Banking Transfer REF# 58190049....................  From HODGES,JUSTINE B 532694 Share 01",40.00,"1,040.00"
03/31,"Withdrawal Home Banking Transfer REF# 58312662..............  To HODGES,JUSTINE B 532694 Share 10","-1,040.00",0.00
03/31,Deposit Dividend Tiered Rate..................................................  Annual Percentage Yield Earned 0.090% for period: 03/27/23 to 03/31/23 Ending Balance............................................................................. 0.01 No Strings Checking - 12 NO STRINGS CHECKING Dividends Earned YTD: 0.00 JointOwner:TYMITCHELL Beginning Balance + Deposits & Other Credits (1) - Checks Cleared (0) - Withdrawals & Other Debits (0) = Ending Balance $0.00 $150.00 $0.00 $0.00 $150.00 TransDate EffDate TransactionDescription Amount Balance Beginning Balance......................................................................... 0.00,0.01,0.01
03/27,"Deposit Home Banking Transfer REF# 58189594....................  From HODGES,JUSTINE B 532694 Share 11 Ending Balance............................................................................. 150.00 Equal Housing Opportunity Ent is a registered trademark of Ent Credit Union Insured by NCUA AccountNumber 1159412 StatementPeriod03/27/23thru03/31/23 Page 3 of 3 1111111111111111111111010001001101110111001110011010100110000001010000001111000011000001101010000110000001000100001101110011000001111000100110000000100101000100000010100110110111000110000100010101010101110011111010000111101110000111010001101101011001011010011111111011101011111100100111000110110011000111010110110000010100011010010110111111001001000101111101111001001011101101010110010011001101111101111110010011110111011000110011010100000110110100111001001010110101010101010101010101 No Strings Checking - 13 NO STRINGS CHECKING Dividends Earned YTD: 0.00 JointOwner:TYMITCHELL Beginning Balance + Deposits & Other Credits (1) - Checks Cleared (0) - Withdrawals & Other Debits (0) = Ending Balance $0.00 $120.00 $0.00 $0.00 $120.00 TransDate EffDate TransactionDescription Amount Balance Beginning Balance......................................................................... 0.00",150.00,150.00
03/27,"Deposit Home Banking Transfer REF# 58189742....................  From HODGES,JUSTINE B 532694 Share 12 Ending Balance............................................................................. 120.00 YEAR-TO-DATE DIVIDEND SUMMARY Reportable Dividends this Year:............................................................................. 0.02 Reportable dividends of $10.00 or more are reported to the IRS as interest income for the year. ** The Visa Foreign Currency Transaction Fee will be assessed to purchases made outside of the United States as well as to online purchases made within the United States, but the merchant is located outside the United States. ** No-cost loan payment alternatives are available, please call 800-525-9623 for more information. Equal Housing Opportunity Ent is a registered trademark of Ent Credit Union Insured by NCUA 296063-0.84-47785N11.no6 026171333 2-2",120.00,120.00
05/03,Deposit Home Banking Transfer From Share 10......................  REF# 59297865,75.00,"1,989.87"
05/08,Withdrawal Home Banking Transfer To Share 10....................  REF# 59465851,-60.00,"1,929.87"
05/08,Withdrawal Transfer To Share 10............................................ ,-19.33,"1,910.54"
05/08,Withdrawal Home Banking Transfer To Share 10....................  REF# 59465949,-50.00,"1,860.54"
05/09,Withdrawal Home Banking Transfer To Share 10....................  REF# 59479951,-150.00,"1,710.54"
05/09,Deposit at ATM #000000005154.............................................  ENT CREDIT UNION 7339 DURYEA DRIVE COLORADO SPRI CO,150.00,"1,860.54"
05/12,Deposit ACH UNIVERSITY OF CO............................................  TYPE: DIR DEP CO: UNIVERSITY OF CO,156.89,"2,017.43"
05/14,Withdrawal Transfer To Share 10............................................ ,-12.90,"2,004.53"
05/14,Withdrawal Home Banking Transfer To Share 10....................  Equal Housing Opportunity Ent is a registered trademark of Ent Credit Union Insured by NCUA AccountNumber 1159412 StatementPeriod05/01/23thru05/31/23 Page 2 of 13 Primary Savings - 00 PRIMARY SAVINGS (continued) TransDate EffDate TransactionDescription Amount Balance REF# 59614833,-60.00,"1,944.53"
05/14,Withdrawal Home Banking Transfer To Share 10....................  REF# 59616594,-50.00,"1,894.53"
05/15,Withdrawal Home Banking Transfer To Share 10....................  REF# 59659522,-200.00,"1,694.53"
05/16,Withdrawal Home Banking Transfer To Share 10....................  REF# 59689300 DEP PRENOTIFICATION FROM Colorado Springs,-450.00,"1,244.53"
05/19,Withdrawal Transfer To Share 10............................................ ,-6.60,"1,237.93"
05/26,Deposit ACH UNIVERSITY OF CO............................................  TYPE: DIR DEP CO: UNIVERSITY OF CO,156.89,"1,394.82"
05/27,Withdrawal Home Banking Transfer To Share 10....................  REF# 59985523,-80.00,"1,314.82"
05/28,Withdrawal Transfer To Share 10............................................ ,-45.21,"1,269.61"
05/28,Withdrawal Transfer To Share 10............................................ ,-32.43,"1,237.18"
05/28,Deposit Home Banking Transfer From Share 10......................  REF# 60013228,80.00,"1,317.18"
05/31,"Deposit Dividend 0.050%........................................................  Annual Percentage Yield Earned 0.050% for period: 05/01/23 to 05/31/23 Ending Balance............................................................................. 1,317.25 No Strings Checking - 10 NO STRINGS CHECKING Dividends Earned YTD: 0.01 JointOwner:TYMITCHELL Beginning Balance + Deposits & Other Credits (33) - Checks Cleared (0) - Withdrawals & Other Debits (96) = Ending Balance $252.15 $5,443.50 $0.00 $5,682.63 $13.02 TransDate EffDate TransactionDescription Amount Balance Beginning Balance......................................................................... 252.15",0.07,"1,317.25"
05/01,04/30 Withdrawal Debit Card Visa Check...........................................  PP*DUTCHBROSLL GRANTS PASS OR 5814,-10.74,241.41
05/01,Withdrawal Debit Card Visa Check...........................................  094 TORCHYS COLORADO SP COLORADO SPRI CO 5812,-5.91,235.50
05/02,Withdrawal POS #312212933782...........................................  KUM&GO 0667R CO SPRIN CO SPRINGS CO 5541,-6.31,229.19
05/02,Withdrawal POS #312213315401...........................................  CIRCLE K # 40693 COLORADO SPRI CO 5541,-3.60,225.59
05/02,Recurring Withdrawal #312214627770...................................  8667127753 APPLE COM BILL CUPERTINO CA Equal Housing Opportunity Ent is a registered trademark of Ent Credit Union Insured by NCUA AccountNumber 1159412 StatementPeriod05/01/23thru05/31/23 Page 3 of 13 1111111111111111111111010011001100110111001110011000100010000001110000000101100011000001101011000110000001100100001110010011000001111000101010000000000111000101110010100101110111001010000100111001010101010011111010100011111111000111011001111101010001011001100111111110100011101111110101010010110000000111111111001000100000001100110000001110111000111111111011111011110001001100000010101110001010011100000101001101101011001110110011011100110111000110001000101010110101010101010101010101 No Strings Checking - 10 NO STRINGS CHECKING (continued) TransDate EffDate TransactionDescription Amount Balance,-0.99,224.60
05/03,Withdrawal Debit Card Visa Check...........................................  TARGET 00022210 COLORADO SPRI CO 5411,-19.45,205.15
05/03,Withdrawal Debit Card Visa Check...........................................  CIRCLE K # 40693 COLORADO SPRI CO 5542,-34.94,170.21
05/03,Deposit ACH SUCCESS FOODS MA.........................................  TYPE: PAYROLL CO: SUCCESS FOODS MA,931.43,"1,101.64"
05/03,Withdrawal Home Banking Transfer To Share 11....................  REF# 59297846,-300.00,801.64
05/03,"Withdrawal Home Banking Transfer REF# 59297850..............  To HODGES,JUSTINE B 532694 Share 11",-150.00,651.64
05/03,Withdrawal Home Banking Transfer To Share 13....................  REF# 59297857,-150.00,501.64
05/03,Withdrawal Home Banking Transfer To Share 00....................  REF# 59297865,-75.00,426.64
05/03,"Withdrawal Home Banking Transfer REF# 59297881..............  To HODGES,JUSTINE B 532694 Share 10",-70.00,356.64
05/03,Withdrawal Debit Card Visa Check...........................................  AMZN Mktp US*F71DH8I53 Amzn.com/bill WA 5942,-9.45,347.19
05/03,Withdrawal POS #312314555822...........................................  KUM&GO 0667R CO SPRIN CO SPRINGS CO 5541,-5.90,341.29
05/03,Withdrawal Debit Card Visa Check...........................................  AMZN Mktp US*FE0L61B93 Amzn.com/bill WA 5942,-18.65,322.64
05/03,Withdrawal Debit Card Visa Check...........................................  WALMART.COM 800-966-6546 AR 5310,-43.27,279.37
05/04,Withdrawal Debit Card Visa Check...........................................  TARGET 00022210 COLORADO SPRI CO 5411,-22.76,256.61
05/04,Withdrawal Debit Card Visa Check...........................................  2574PEPSIVEN9147678600 COLORADO SPRI CO 5814,-2.25,254.36
05/05,Withdrawal POS #312511862912...........................................  KUM&GO 0667R CO SPRIN CO SPRINGS CO 5541,-15.52,238.84
05/05,Withdrawal at ATM #000000002119.......................................  ENT CREDIT UNION 7339 DURYEA DRIVE Equal Housing Opportunity Ent is a registered trademark of Ent Credit Union Insured by NCUA 390530-1.58-78984N11.no8 027480567 2-7 AccountNumber 1159412 StatementPeriod05/01/23thru05/31/23 Page 4 of 13 No Strings Checking - 10 NO STRINGS CHECKING (continued) TransDate EffDate TransactionDescription Amount Balance COLORADO SPRI CO,-150.00,88.84
05/05,Withdrawal POS #312516310431...........................................  AUTOZONE 4059 11735 ME PEYTON CO 5533,-58.32,30.52
05/05,Deposit Home Banking Transfer From Share 13......................  REF# 59379419,200.00,230.52
05/05,Withdrawal Debit Card Visa Check...........................................  094 TORCHYS COLORADO SP COLORADO SPRI CO 5812,-11.23,219.29
05/05,Withdrawal Debit Card Visa Check...........................................  AUTOZONE 4059 719-494-1877 CO 5533,-36.76,182.53
05/06,Withdrawal Debit Card Visa Check...........................................  SONIC DRIVE IN #5256 COLORADO SPRI CO 5814,-6.59,175.94
05/06,Withdrawal Debit Card Visa Check...........................................  2574PEPSIVEN9147678600 COLORADO SPRI CO 5814,-2.25,173.69
05/06,Withdrawal POS #312611677104...........................................  KUM&GO 0667R CO SPRIN CO SPRINGS CO 5541,-11.80,161.89
05/06,Withdrawal POS #312600511771...........................................  KING SOOPERS #0119 9225 N. UNION COLORADO SPRI CO 5411,-28.60,133.29
05/06,Withdrawal POS #312613838091...........................................  MAVERIK #608 COLORADO SPRI CO 5542,-57.60,75.69
05/06,Deposit Home Banking Transfer From Share 12......................  REF# 59415243,30.00,105.69
05/07,Withdrawal Debit Card Visa Check...........................................  MAVERIK #608 COLORADO SPRI CO 5541,-6.05,99.64
05/07,Recurring Withdrawal Debit Card Visa Check..........................  COOKBOOK MOUNT COOLUM AU 5734,-1.49,98.15
05/07,Recurring Withdrawal Card Fee...............................................  VISA INTERNATIONAL SERVICE ASSESSMENT Date 05/07/23,-0.01,98.14
05/07,Withdrawal POS #312713895803...........................................  KUM&GO 0667R CO SPRIN CO SPRINGS CO 5541,-5.18,92.96
05/07,Deposit Home Banking Transfer From Share 12......................  REF# 59427649,120.00,212.96
05/07,Withdrawal Debit Card Visa Check...........................................  094 TORCHYS COLORADO SP COLORADO SPRI CO 5812,-6.42,206.54
05/07,Withdrawal POS #312720042817...........................................  LOWEâ€™S #2578 COLORADO SPGS CO 5200,-28.11,178.43
05/08,Withdrawal Debit Card Visa Check...........................................  Equal Housing Opportunity Ent is a registered trademark of Ent Credit Union Insured by NCUA AccountNumber 1159412 StatementPeriod05/01/23thru05/31/23 Page 5 of 13 1111111111111111111111010011001100110001001110011000100010000001110000000101100011000001101011000110000001101100001110010011000000111000101010000000001101000101110010100111010111001010000100001111010101010011111011010111111111000111010111001100010001011001000010111010100011000011001011000010110010100001010111001000111011010001010001001111111011101111111010000011000000001100011100011100000011111011000111110101000011000111010010111100000111000010001000001011010101010101010101010101 No Strings Checking - 10 NO STRINGS CHECKING (continued) TransDate EffDate TransactionDescription Amount Balance PANDA EXPRESS #3387 COLORADO SPRI CO 5814,-12.13,166.30
05/08,Withdrawal Debit Card Visa Check...........................................  094 TORCHYS COLORADO SP COLORADO SPRI CO 5812,-5.94,160.36
05/08,Deposit Home Banking Transfer From Share 00......................  REF# 59465851,60.00,220.36
05/08,Deposit Transfer From Share 00.............................................. ,19.33,239.69
05/08,Withdrawal POS #312820836490...........................................  COSTCO WHSE #1014 COLORADO SPRI CO 5300,-239.69,0.00
05/08,Deposit Home Banking Transfer From Share 00......................  REF# 59465949,50.00,50.00
05/08,Withdrawal POS #312901626718...........................................  KING SOOPERS #01 9225 N COLORADO SPRI CO 5411,-49.98,0.02
05/09,Deposit Home Banking Transfer From Share 00......................  REF# 59479951,150.00,150.02
05/09,Withdrawal POS #312900123838...........................................  KING SOOPERS #719 FUEL 9255 N UNION BL COLORADO SPRI CO 5542,-60.38,89.64
05/09,Withdrawal Debit Card Visa Check...........................................  Amazon.com*5Y7ZQ3HP3 Amzn.com/bill WA 5942,-64.09,25.55
05/10,Recurring Withdrawal #313021717980...................................  ADOBE *CREATIVE CLOUD 408-536-6000 CA,-20.60,4.95
05/11,"Deposit Home Banking Transfer REF# 59532771....................  From HODGES,JUSTINE B 532694 Share 10",100.00,104.95
05/11,Withdrawal Debit Card Visa Check...........................................  6005 CRUNCH N CO SPRING COLORADO SPRI CO 7997,-3.88,101.07
05/11,Withdrawal Debit Card Visa Check...........................................  IBI*FABLETICS.COM 855-2023570 CA 5968,-59.95,41.12
05/12,Deposit ACH UNIVERSITY OF CO............................................  TYPE: DIR DEP CO: UNIVERSITY OF CO,627.55,668.67
05/12,Withdrawal Debit Card Visa Check...........................................  Amazon.com*UK2731883 Amzn.com/bill WA 5942,-39.18,629.49
05/12,Withdrawal POS #313214755150...........................................  KUM&GO 0659R CO SPRIN CO SPRINGS CO 5541 Equal Housing Opportunity Ent is a registered trademark of Ent Credit Union Insured by NCUA 390530-1.58-78984N11.no8 027480567 3-7 AccountNumber 1159412 StatementPeriod05/01/23thru05/31/23 Page 6 of 13 No Strings Checking - 10 NO STRINGS CHECKING (continued) TransDate EffDate TransactionDescription Amount Balance,-13.09,616.40
05/12,Withdrawal Home Banking Transfer To Share 11....................  REF# 59582555,-300.00,316.40
05/12,Withdrawal Home Banking Transfer To Share 12....................  REF# 59582568,-150.00,166.40
05/12,"Withdrawal Home Banking Transfer REF# 59582648..............  To HODGES,JUSTINE B 532694 Share 10",-35.00,131.40
05/12,Withdrawal Home Banking Transfer To Share 13....................  REF# 59582711,-56.00,75.40
05/13,Withdrawal POS #313300012501...........................................  KING SOOPERS #0119 9225 N. UNION COLORADO SPRI CO 5411,-13.26,62.14
05/13,Deposit Home Banking Transfer From Share 12......................  REF# 59607238,62.00,124.14
05/14,Recurring Withdrawal #313403573000...................................  8667127753 APPLE COM BILL CUPERTINO CA,-0.99,123.15
05/14,Deposit Transfer From Share 00.............................................. ,12.90,136.05
05/14,Recurring Withdrawal #313410578982...................................  8667127753 APPLE COM BILL CUPERTINO CA,-15.99,120.06
05/14,Deposit Home Banking Transfer From Share 12......................  REF# 59614826,88.01,208.07
05/14,Deposit Home Banking Transfer From Share 00......................  REF# 59614833,60.00,268.07
05/14,Deposit Home Banking Transfer From Share 00......................  REF# 59616594,50.00,318.07
05/14,Withdrawal POS #313412473477...........................................  COSTCO WHSE #1014 COLORADO SPRI CO 5300,-168.91,149.16
05/14,Withdrawal Debit Card Visa Check...........................................  CHICK-FIL-A #03985 COLORADO SPRI CO 5814,-28.19,120.97
05/14,Withdrawal Debit Card Visa Check...........................................  PURPLE TOAD SOCIAL TAP 719-2873495 CO 5812,-20.00,100.97
05/15,Withdrawal Debit Card Visa Check...........................................  MADERAS GRILL & CANTINA PEYTON CO 5812,-29.00,71.97
05/15,Recurring Withdrawal Debit Card Visa Check..........................  KING SOOPERS #5076 719-590-1099 CO 5411,-49.60,22.37
05/15,Deposit Home Banking Transfer From Share 00......................  Equal Housing Opportunity Ent is a registered trademark of Ent Credit Union Insured by NCUA AccountNumber 1159412 StatementPeriod05/01/23thru05/31/23 Page 7 of 13 1111111111111111111111010011001100110011001110011000100010010001110000000101100011000001101011000110000001100100001110010011000010011000101010000000001101000101110010100101110111001010000100100001010101010011111001001011111111000111110100001100010001011011001010111010100011011111110101010010110001011101010111001000111110001001110000011100101010110111111111011001111011001101001101100001010010111111000100100101111011001011110001110100000111000110001001101011010101010101010101010101 No Strings Checking - 10 NO STRINGS CHECKING (continued) TransDate EffDate TransactionDescription Amount Balance REF# 59659522,200.00,222.37
05/15,Withdrawal POS #313521598565...........................................  WOODCRAFT 501 Colorado Spri CO 5999,-159.42,62.95
05/16,Withdrawal POS #313615507897...........................................  KUM&GO 0657R CO SPRIN CO SPRINGS CO 5541,-5.58,57.37
05/16,Deposit Home Banking Transfer From Share 00......................  REF# 59689300,450.00,507.37
05/16,Deposit Home Banking Transfer From Share 13......................  REF# 59694356,40.00,547.37
05/16,Withdrawal Debit Card Visa Check...........................................  WAGPET* MICROCHIP WWW.PETSTABLI NY 5995,-12.99,534.38
05/17,Withdrawal Debit Card Visa Check...........................................  SONIC DRIVE IN #5256 COLORADO SPRI CO 5814,-6.59,527.79
05/17,Deposit ACH SUCCESS FOODS MA.........................................  TYPE: PAYROLL CO: SUCCESS FOODS MA,735.49,"1,263.28"
05/17,Withdrawal Home Banking Transfer To Share 11....................  REF# 59696953,-300.00,963.28
05/17,Withdrawal Home Banking Transfer To Share 12....................  REF# 59696955,-150.00,813.28
05/17,Withdrawal Home Banking Transfer To Share 13....................  REF# 59696958 DEP PRENOTIFICATION FROM Colorado Springs,-100.00,713.28
05/17,Withdrawal Debit Card Visa Check...........................................  AMZN Mktp US*1C34D5H43 Amzn.com/bill WA 5942,-56.52,656.76
05/17,Withdrawal Debit Card Visa Check...........................................  IN *EL PASO COUNTY CANI 719-3589933 CO 7299,-463.50,193.26
05/18,"Deposit Home Banking Transfer REF# 59744236....................  From HODGES,JUSTINE B 532694 Loan 01",100.00,293.26
05/18,"Withdrawal Home Banking Transfer REF# 59744305..............  To HODGES,JUSTINE B 532694 Share 10",-50.00,243.26
05/18,Withdrawal Debit Card Visa Check...........................................  PLAZA DELICATESSEN COLORADO SPRI CO 5814 Equal Housing Opportunity Ent is a registered trademark of Ent Credit Union Insured by NCUA 390530-1.58-78984N11.no8 027480567 4-7 AccountNumber 1159412 StatementPeriod05/01/23thru05/31/23 Page 8 of 13 No Strings Checking - 10 NO STRINGS CHECKING (continued) TransDate EffDate TransactionDescription Amount Balance,-10.00,233.26
05/19,Withdrawal Debit Card Visa Check...........................................  TARGET 00022210 COLORADO SPRI CO 5411,-88.83,144.43
05/19,Withdrawal Debit Card Visa Check...........................................  DOMINOâ€™S 6246 COLORADO SPRI CO 5814,-29.18,115.25
05/19,Withdrawal Debit Card Visa Check...........................................  KUM&GO 0659R CO SPRIN CO SPRINGS CO 5542,-56.19,59.06
05/19,Deposit Transfer From Share 00.............................................. ,6.60,65.66
05/19,Withdrawal POS #313921811715...........................................  COSTCO WHSE #1014 COLORADO SPRI CO 5300,-65.66,0.00
05/19,Deposit Home Banking Transfer From Share 13......................  REF# 59790134,60.00,60.00
05/21,Deposit Home Banking Transfer From Share 12......................  REF# 59820680,150.00,210.00
05/21,Withdrawal POS #314118550960...........................................  KING SOOPERS #01 9225 N COLORADO SPRI CO 5411,-94.86,115.14
05/21,Withdrawal POS #314114869033...........................................  COSTCO WHSE #1014 COLORADO SPRI CO 5300,-15.88,99.26
05/22,Withdrawal Debit Card Visa Check...........................................  AMZN Mktp US*YE3G365Z3 Amzn.com/bill WA 5942,-17.57,81.69
05/22,Withdrawal POS #314208565940...........................................  KUM&GO 0667R CO SPRIN CO SPRINGS CO 5541,-6.23,75.46
05/22,Withdrawal Debit Card Visa Check...........................................  Amazon.com*NW01W5VY3 Amzn.com/bill WA 5942,-19.44,56.02
05/23,Deposit Home Banking Transfer From Share 13......................  REF# 59868244,50.00,106.02
05/23,Withdrawal POS #314300126987...........................................  KING SOOPERS #719 FUEL 9255 N UNION BL COLORADO SPRI CO 5542,-50.05,55.97
05/25,Deposit at ATM #000000008094.............................................  ENT CREDIT UNION 7339 DURYEA DRIVE COLORADO SPRI CO,55.00,110.97
05/26,Deposit ACH UNIVERSITY OF CO............................................  TYPE: DIR DEP CO: UNIVERSITY OF CO,627.55,738.52
05/26,Withdrawal Home Banking Transfer To Share 11....................  REF# 59946124,-300.00,438.52
05/26,Withdrawal Home Banking Transfer To Share 12....................  REF# 59946135 Equal Housing Opportunity Ent is a registered trademark of Ent Credit Union Insured by NCUA AccountNumber 1159412 StatementPeriod05/01/23thru05/31/23 Page 9 of 13 1111111111111111111111010011001100110101001110011000100010000001110000000101100011000001101011000110000001000100001110010011000000111000101010000000100001000101110010100110110111001010000100110111010101010011111011101011111111000111101100001100010001011000001111111110100011111100001101000010110001111001111111001000001110000001110000101111011010111111111010011011010011101101101010100111001101111000001010000111100011000010010011100100100111000010001000001011110101010101010101010101 No Strings Checking - 10 NO STRINGS CHECKING (continued) TransDate EffDate TransactionDescription Amount Balance,-175.00,263.52
05/26,Withdrawal Home Banking Transfer To Share 13....................  REF# 59946155,-120.00,143.52
05/26,"Withdrawal Home Banking Transfer REF# 59946173..............  To HODGES,JUSTINE B 532694 Share 01",-25.00,118.52
05/26,Withdrawal POS #314619485119...........................................  PETCO 1472 COLORADO SPRI CO 5995,-26.49,92.03
05/27,Withdrawal Debit Card Visa Check...........................................  POPEYES 5490 / 404 COLORADO SPGS CO 5814,-21.62,70.41
05/27,Deposit Home Banking Transfer From Share 00......................  REF# 59985523,80.00,150.41
05/27,Deposit Home Banking Transfer From Share 13......................  REF# 59986948,50.00,200.41
05/27,Withdrawal POS #314700118324...........................................  KING SOOPERS #719 FUEL 9255 N UNION BL COLORADO SPRI CO 5542,-54.04,146.37
05/27,Withdrawal POS #314714964259...........................................  KING SOOPERS #01 9225 N COLORADO SPRI CO 5411,-63.55,82.82
05/28,05/27 Withdrawal Debit Card Visa Check...........................................  AMZN Mktp US*KE5433BM3 Amzn.com/bill WA 5942,-28.39,54.43
05/28,Deposit Transfer From Share 00.............................................. ,45.21,99.64
05/28,Withdrawal POS #314815030772...........................................  COSTCO WHSE #1014 COLORADO SPRI CO 5300,-99.64,0.00
05/28,Deposit Transfer From Share 00.............................................. ,32.43,32.43
05/28,Withdrawal POS #314816919142...........................................  MOUNTAIN LIQUORS COLORADO SPRI CO 5921,-32.43,0.00
05/28,Deposit Home Banking Transfer From Share 12......................  REF# 60013199,175.00,175.00
05/28,Withdrawal Home Banking Transfer To Share 00....................  REF# 60013228,-80.00,95.00
05/28,Withdrawal POS #314820311480...........................................  KING SOOPERS #01 9225 N COLORADO SPRI CO 5411,-44.43,50.57
05/28,Withdrawal POS #314822824843...........................................  KING SOOPERS #01 9225 N COLORADO SPRI CO 5411,-27.65,22.92
05/28,Deposit Home Banking Transfer From Share 13......................  Equal Housing Opportunity Ent is a registered trademark of Ent Credit Union Insured by NCUA 390530-1.58-78984N11.no8 027480567 5-7 AccountNumber 1159412 StatementPeriod05/01/23thru05/31/23 Page 10 of 13 No Strings Checking - 10 NO STRINGS CHECKING (continued) TransDate EffDate TransactionDescription Amount Balance REF# 60017756,20.00,42.92
05/29,Withdrawal Debit Card Visa Check...........................................  STEAMGAMES.COM 42595229 425-8899642 WA 5816,-15.45,27.47
05/30,Deposit Home Banking Transfer From Share 13......................  REF# 60062103,5.00,32.47
05/30,Withdrawal POS #315023748096...........................................  KING SOOPERS #01 9225 N COLORADO SPRI CO 5411,-10.98,21.49
05/31,Withdrawal POS #315117948752...........................................  KUM&GO 0667R CO SPRIN CO SPRINGS CO 5541,-3.21,18.28
05/31,"Withdrawal POS #315118883149...........................................  7-ELEVEN Colorado Spri CO 5541 Ending Balance............................................................................. 13.02 No Strings Checking - 11 NO STRINGS CHECKING Dividends Earned YTD: 0.08 JointOwner:TYMITCHELL Beginning Balance + Deposits & Other Credits (5) - Checks Cleared (0) - Withdrawals & Other Debits (2) = Ending Balance $1,200.05 $1,200.03 $0.00 $2,400.00 $0.08 TransDate EffDate TransactionDescription Amount Balance Beginning Balance......................................................................... 1,200.05",-5.26,13.02
05/01,Withdrawal Home Banking......................................................  ACH WITHDRAWAL US BANK NA - JUSTINE HODGES,"-1,200.00",0.05
05/03,Deposit Home Banking Transfer From Share 10......................  REF# 59297846,300.00,300.05
05/12,Deposit Home Banking Transfer From Share 10......................  REF# 59582555,300.00,600.05
05/17,Deposit Home Banking Transfer From Share 10......................  REF# 59696953,300.00,900.05
05/26,Deposit Home Banking Transfer From Share 10......................  REF# 59946124,300.00,"1,200.05"
05/30,Withdrawal Home Banking......................................................  ACH WITHDRAWAL US BANK NA - JUSTINE HODGES,"-1,200.00",0.05
05/31,Deposit Dividend Tiered Rate..................................................  Annual Percentage Yield Earned 0.060% for period: 05/01/23 to 05/31/23 Ending Balance............................................................................. 0.08 Equal Housing Opportunity Ent is a registered trademark of Ent Credit Union Insured by NCUA AccountNumber 1159412 StatementPeriod05/01/23thru05/31/23 Page 11 of 13 1111111111111111111111010011001100110111001110011000100010010001110000000101100011000001101011000110000001001100001110010011000010011000101010000000100001000101110010100100010111001010000100011001010101010011111001110111111111000111001111001100010001011010000111111110100011100000110011010010110010000101111111001000001011011001010001111100001011100111111111000001101000101100111011011010011100111100001001010111011011001110110000101100100111000110001001101011110101010101010101010101 No Strings Checking - 12 NO STRINGS CHECKING Dividends Earned YTD: 0.01 JointOwner:TYMITCHELL Beginning Balance + Deposits & Other Credits (4) - Checks Cleared (0) - Withdrawals & Other Debits (6) = Ending Balance $0.01 $625.00 $0.00 $625.01 $0.00 TransDate EffDate TransactionDescription Amount Balance Beginning Balance......................................................................... 0.01,0.03,0.08
05/03,"Deposit Home Banking Transfer REF# 59297925....................  From HODGES,JUSTINE B 532694 Share 11",150.00,150.01
05/06,Withdrawal Home Banking Transfer To Share 10....................  REF# 59415243,-30.00,120.01
05/07,Withdrawal Home Banking Transfer To Share 10....................  REF# 59427649,-120.00,0.01
05/12,Deposit Home Banking Transfer From Share 10......................  REF# 59582568,150.00,150.01
05/13,Withdrawal Home Banking Transfer To Share 10....................  REF# 59607238,-62.00,88.01
05/14,Withdrawal Home Banking Transfer To Share 10....................  REF# 59614826,-88.01,0.00
05/17,Deposit Home Banking Transfer From Share 10......................  REF# 59696955,150.00,150.00
05/21,Withdrawal Home Banking Transfer To Share 10....................  REF# 59820680,-150.00,0.00
05/26,Deposit Home Banking Transfer From Share 10......................  REF# 59946135,175.00,175.00
05/28,Withdrawal Home Banking Transfer To Share 10....................  REF# 60013199 Ending Balance............................................................................. 0.00 Equal Housing Opportunity Ent is a registered trademark of Ent Credit Union Insured by NCUA 390530-1.58-78984N11.no8 027480567 6-7 AccountNumber 1159412 StatementPeriod05/01/23thru05/31/23 Page 12 of 13 No Strings Checking - 13 NO STRINGS CHECKING Dividends Earned YTD: 0.01 JointOwner:TYMITCHELL Beginning Balance + Deposits & Other Credits (4) - Checks Cleared (0) - Withdrawals & Other Debits (7) = Ending Balance $94.01 $426.00 $0.00 $425.00 $95.01 TransDate EffDate TransactionDescription Amount Balance Beginning Balance......................................................................... 94.01,-175.00,0.00
05/03,Deposit Home Banking Transfer From Share 10......................  REF# 59297857,150.00,244.01
05/05,Withdrawal Home Banking Transfer To Share 10....................  REF# 59379419,-200.00,44.01
05/12,Deposit Home Banking Transfer From Share 10......................  REF# 59582711,56.00,100.01
05/16,Withdrawal Home Banking Transfer To Share 10....................  REF# 59694356,-40.00,60.01
05/17,Deposit Home Banking Transfer From Share 10......................  REF# 59696958,100.00,160.01
05/19,Withdrawal Home Banking Transfer To Share 10....................  REF# 59790134,-60.00,100.01
05/23,Withdrawal Home Banking Transfer To Share 10....................  REF# 59868244,-50.00,50.01
05/26,Deposit Home Banking Transfer From Share 10......................  REF# 59946155,120.00,170.01
05/27,Withdrawal Home Banking Transfer To Share 10....................  REF# 59986948,-50.00,120.01
05/28,Withdrawal Home Banking Transfer To Share 10....................  REF# 60017756,-20.00,100.01
05/30,"Withdrawal Home Banking Transfer To Share 10....................  REF# 60062103 Ending Balance............................................................................. 95.01 YEAR-TO-DATE DIVIDEND SUMMARY Reportable Dividends this Year:............................................................................. 0.26 Equal Housing Opportunity Ent is a registered trademark of Ent Credit Union Insured by NCUA AccountNumber 1159412 StatementPeriod05/01/23thru05/31/23 Page 13 of 13 1111111111111111111111010001001100111001001110011000100010010001110000000101100011000001101011000110000001110100001110010011000000111000101010000000101101000101110010100111010111001010000100011101010101010011111011000011111111000111000100011101010001011000001000111010100011110011011111000010110011011100110111001000101011101110010001101110001011110111111101000110001110101100010101110101100001111011011001110111101111001101110011100100110111000100111000001010010101010101010101010101 YEAR-TO-DATE-DIVIDEND SUMMARY (continued) Reportable dividends of $10.00 or more are reported to the IRS as interest income for the year. ** The Visa Foreign Currency Transaction Fee will be assessed to purchases made outside of the United States as well as to online purchases made within the United States, but the merchant is located outside the United States. ** No-cost loan payment alternatives are available, please call 800-525-9623 for more information. Equal Housing Opportunity Ent is a registered trademark of Ent Credit Union Insured by NCUA 390530-1.58-78984N11.no8 027480567 7-7",-5.00,95.01
09/01,Deposit ACH UNIVERSITY OF CO............................................  TYPE: DIR DEP CO: UNIVERSITY OF CO,252.47,"1,289.21"
09/06,Withdrawal Home Banking Transfer To Share 10....................  REF# 63056330,-50.00,"1,239.21"
09/07,Withdrawal Transfer To Share 10............................................ ,-12.01,"1,227.20"
09/07,Withdrawal Transfer To Share 10............................................ ,-94.08,"1,133.12"
09/08,Deposit ACH Colorado Springs................................................  TYPE: PR PAYMENT CO: Colorado Springs,133.75,"1,266.87"
09/10,Withdrawal Home Banking Transfer To Share 10....................  REF# 63172112,-235.00,"1,031.87"
09/15,Deposit ACH UNIVERSITY OF CO............................................  TYPE: DIR DEP CO: UNIVERSITY OF CO,165.44,"1,197.31"
09/17,Withdrawal Transfer To Share 10............................................ ,-48.34,"1,148.97"
09/18,Withdrawal Transfer To Share 10............................................ ,-8.98,"1,139.99"
09/18,Withdrawal Transfer To Share 10............................................ ,-7.98,"1,132.01"
09/18,"Withdrawal Home Banking Transfer REF# 63402488..............  Equal Housing Opportunity Ent is a registered trademark of Ent Credit Union Insured by NCUA AccountNumber 1159412 StatementPeriod09/01/23thru09/30/23 Page 2 of 11 Primary Savings - 00 PRIMARY SAVINGS (continued) TransDate EffDate TransactionDescription Amount Balance To MITCHELL,JUSTINE 532694 Share 10",-175.00,957.01
09/18,Withdrawal Home Banking Transfer To Share 10....................  REF# 63402504,-175.00,782.01
09/22,Deposit ACH Colorado Springs................................................  TYPE: PR PAYMENT CO: Colorado Springs,131.94,913.95
09/22,Withdrawal Home Banking Transfer To Share 10....................  REF# 63528973,-92.00,821.95
09/28,Withdrawal Home Banking Transfer To Share 10....................  REF# 63683950,-300.00,521.95
09/28,"Withdrawal Home Banking Transfer REF# 63699907..............  To MITCHELL,JUSTINE 532694 Share 10",-100.00,421.95
09/29,Deposit ACH UNIVERSITY OF CO............................................  TYPE: DIR DEP CO: UNIVERSITY OF CO,165.44,587.39
09/30,"Deposit Dividend 0.050%........................................................  Annual Percentage Yield Earned 0.050% for period: 09/01/23 to 09/30/23 Ending Balance............................................................................. 587.43 No Strings Checking - 10 NO STRINGS CHECKING Dividends Earned YTD: 0.06 JointOwner:TYMITCHELL Beginning Balance + Deposits & Other Credits (22) - Checks Cleared (0) - Withdrawals & Other Debits (87) = Ending Balance $97.92 $5,206.01 $0.00 $4,688.41 $615.52 TransDate EffDate TransactionDescription Amount Balance Beginning Balance......................................................................... 97.92",0.04,587.43
09/01,08/31 Withdrawal Debit Card Visa Check...........................................  SQ *PIKES PEAK LEMONADE Colorado Spri CO 5814,-7.33,90.59
09/01,Deposit ACH UNIVERSITY OF CO............................................  TYPE: DIR DEP CO: UNIVERSITY OF CO,"1,009.87","1,100.46"
09/01,Withdrawal Debit Card Visa Check...........................................  KUM&GO 0659R CO SPRIN CO SPRINGS CO 5541,-12.45,"1,088.01"
09/01,Withdrawal Home Banking Transfer To Share 11....................  REF# 62924927,-300.00,788.01
09/01,Withdrawal Home Banking Transfer To Share 13....................  REF# 62924945 Equal Housing Opportunity Ent is a registered trademark of Ent Credit Union Insured by NCUA AccountNumber 1159412 StatementPeriod09/01/23thru09/30/23 Page 3 of 11 1111111111111111111111010011001101110111001110011010100010000001010000000111010011000011101011000110000001010100001111100011000010011000100110000000110101000100100010100111110111001110000100010011010110010011111011010011101010100111110101011100101001011010011010111110111011011111011101011000110001110000001111010000011101001011010000111111111011111111111001100011001000110101011111110111001010011111100101000010110111010100010011100100110111110110001001101010110101010101010101010101 No Strings Checking - 10 NO STRINGS CHECKING (continued) TransDate EffDate TransactionDescription Amount Balance,-90.00,698.01
09/01,"Withdrawal Home Banking Transfer REF# 62924959..............  To HODGES,JUSTINE B 532694 Share 01",-150.00,548.01
09/01,"Withdrawal Home Banking Transfer REF# 62924979..............  To HODGES,JUSTINE B 532694 Share 11",-70.00,478.01
09/01,"Withdrawal Home Banking Transfer REF# 62924988..............  To HODGES,JUSTINE B 532694 Share 12",-100.00,378.01
09/02,Recurring Withdrawal #324525101173...................................  Audible*TL43S23Q0 Amzn.com/bill NJ,-16.18,361.83
09/02,Withdrawal POS #324516440325...........................................  COSTCO WHSE #1014 COLORADO SPRI CO 5300,-130.12,231.71
09/03,Recurring Withdrawal Debit Card Visa Check..........................  APPLE.COM/BILL 866-712-7753 CA 5818,-0.99,230.72
09/03,Withdrawal POS #324614750334...........................................  KING SOOPERS #01 9225 N COLORADO SPRI CO 5411,-48.88,181.84
09/03,Withdrawal Debit Card Visa Check...........................................  TACO BELL 037400 COLORADO SPRI CO 5814,-5.41,176.43
09/03,Recurring Withdrawal Debit Card Visa Check..........................  KING SOOPERS #5119 866-576-4377 CO 5411,-73.19,103.24
09/03,Withdrawal Debit Card Visa Check...........................................  AMZN Mktp US*TL03G41X0 Amzn.com/bill WA 5942,-42.34,60.90
09/03,Withdrawal Debit Card Visa Check...........................................  ALBERTACOS MEXICAN FOO COLORADO SPRI CO 5814,-16.80,44.10
09/04,Withdrawal #324723100299...................................................  Amazon Prime*TL93495S0 Amzn.com/bill WA,-16.22,27.88
09/06,Deposit Home Banking Transfer From Share 13......................  REF# 63044754,70.00,97.88
09/06,Withdrawal POS #324900117914...........................................  KING SOOPERS #719 FUEL 9255 N UNION BL COLORADO SPRI CO 5542,-65.88,32.00
09/06,Deposit Home Banking Transfer From Share 00......................  REF# 63056330,50.00,82.00
09/06,Withdrawal Debit Card Visa Check...........................................  Equal Housing Opportunity Ent is a registered trademark of Ent Credit Union Insured by NCUA 397475-1.38-66503N11.no7 029926803 2-6 AccountNumber 1159412 StatementPeriod09/01/23thru09/30/23 Page 4 of 11 No Strings Checking - 10 NO STRINGS CHECKING (continued) TransDate EffDate TransactionDescription Amount Balance DUTCH BROS 541-955-4700 OR 5814,-10.00,72.00
09/06,Withdrawal Debit Card Visa Check...........................................  CHEGG ORDER 8558681054 CA 5942,-20.56,51.44
09/06,Withdrawal Debit Card Visa Check...........................................  DUTCH BROS 541-955-4700 OR 5814,-10.00,41.44
09/07,Recurring Withdrawal Debit Card Visa Check..........................  COOKBOOK MOUNT COOLUM AU 5817,-1.49,39.95
09/07,Recurring Withdrawal Card Fee...............................................  VISA INTERNATIONAL SERVICE ASSESSMENT Date 09/07/23,-0.01,39.94
09/07,Withdrawal Debit Card Visa Check...........................................  KUM&GO 0659R CO SPRIN CO SPRINGS CO 5541,-11.61,28.33
09/07,Deposit Transfer From Share 00.............................................. ,12.01,40.34
09/07,Withdrawal POS #325000126831...........................................  KING SOOPERS #719 FUEL 9255 N UNION BL COLORADO SPRI CO 5542,-40.34,0.00
09/07,Deposit Transfer From Share 00.............................................. ,94.08,94.08
09/07,Withdrawal Debit Card Visa Check...........................................  Amazon.com*TL9G25D81 Amzn.com/bill WA 5942,-94.08,0.00
09/08,Deposit ACH Colorado Springs................................................  TYPE: PR PAYMENT CO: Colorado Springs,713.40,713.40
09/08,Withdrawal Home Banking Transfer To Share 11....................  REF# 63124063,-300.00,413.40
09/08,Withdrawal Home Banking Transfer To Share 13....................  REF# 63124079,-75.00,338.40
09/08,"Withdrawal Home Banking Transfer REF# 63124088..............  To HODGES,JUSTINE B 532694 Share 11",-35.00,303.40
09/08,"Withdrawal Home Banking Transfer REF# 63124146..............  To HODGES,JUSTINE B 532694 Share 01",-40.00,263.40
09/08,Withdrawal Debit Card Visa Check...........................................  6005 CRUNCH N CO SPRING COLORADO SPRI CO 7997,-4.60,258.80
09/09,Withdrawal POS #325218216480...........................................  COSTCO WHSE #1014 COLORADO SPRI CO 5300,-103.46,155.34
09/10,Deposit Home Banking Transfer From Share 00......................  REF# 63172112 Equal Housing Opportunity Ent is a registered trademark of Ent Credit Union Insured by NCUA AccountNumber 1159412 StatementPeriod09/01/23thru09/30/23 Page 5 of 11 1111111111111111111111010011001101110001001110011010100010000001010000000111010011000011101011000110000001101100001111100011000001111000100110000000011011000100100010100100110111001110000100010111010110010011111011001111101010100111100110001101101001011010101110111010111011010111101111001000110010001110001111010000111110010110010000111110001100101111111001001111010010010101110111100001011110011101111110110111110111011001110010110100100111110110001001001011010101010101010101010101 No Strings Checking - 10 NO STRINGS CHECKING (continued) TransDate EffDate TransactionDescription Amount Balance,235.00,390.34
09/10,Recurring Withdrawal #325323745162...................................  ADOBE *CREATIVE CLOUD 408-536-6000 CA,-20.60,369.74
09/10,Withdrawal Debit Card Visa Check...........................................  RAISING CANES 0403 COLORADO SPRI CO 5814,-10.34,359.40
09/10,Withdrawal Debit Card Visa Check...........................................  TARGET 00022210 COLORADO SPRI CO 5411,-80.03,279.37
09/10,Withdrawal Debit Card Visa Check...........................................  DUTCH BROS 541-955-4700 OR 5814,-15.00,264.37
09/11,Withdrawal Debit Card Visa Check...........................................  AMZN Mktp US*TR5OA3B12 Amzn.com/bill WA 5942,-146.40,117.97
09/11,Withdrawal Debit Card Visa Check...........................................  PY *CHEBA HUT TOASTED S COLORADO SPIN CO 5812,-15.18,102.79
09/11,Recurring Withdrawal Debit Card Visa Check..........................  KING SOOPERS #5119 866-576-4377 CO 5411,-51.31,51.48
09/11,Withdrawal Adjustment POS #2SMHZWBGG2KZ....................  AMAZON.COM SEATTLE WA 5942 AMZ*Amazon.com Pending credit/return for $47.03 on card 0950,47.04,98.52
09/11,Withdrawal Adjustment Debit Card Credit Voucher.................  AMZ*Amazon.com AMZN.COM/BILL WA 5942,47.03,145.55
09/12,Withdrawal Debit Card Visa Check...........................................  Amazon.com*TR7GG23H1 Amzn.com/bill WA 5942,-20.00,125.55
09/12,Withdrawal POS #325518543748...........................................  KUM&GO 0659R CO SPRIN CO SPRINGS CO 5541,-14.56,110.99
09/13,Withdrawal Debit Card Visa Check...........................................  KUM&GO 0659R CO SPRIN CO SPRINGS CO 5541,-4.88,106.11
09/14,Withdrawal POS #325700117348...........................................  KING SOOPERS #719 FUEL 9255 N UNION BL COLORADO SPRI CO 5542,-67.39,38.72
09/14,Withdrawal Debit Card Visa Check...........................................  KUM&GO 0659R CO SPRIN CO SPRINGS CO 5541,-8.31,30.41
09/14,Recurring Withdrawal Debit Card Visa Check..........................  Equal Housing Opportunity Ent is a registered trademark of Ent Credit Union Insured by NCUA 397475-1.38-66503N11.no7 029926803 3-6 AccountNumber 1159412 StatementPeriod09/01/23thru09/30/23 Page 6 of 11 No Strings Checking - 10 NO STRINGS CHECKING (continued) TransDate EffDate TransactionDescription Amount Balance APPLE.COM/BILL 866-712-7753 CA 5818,-0.99,29.42
09/14,Recurring Withdrawal Debit Card Visa Check..........................  APPLE.COM/BILL 866-712-7753 CA 5818,-18.99,10.43
09/15,Deposit ACH UNIVERSITY OF CO............................................  TYPE: DIR DEP CO: UNIVERSITY OF CO,661.78,672.21
09/15,"Recurring Withdrawal Debit Card Visa Check..........................  NETFLIX, INC. 186-65797172 CA 4899",-19.99,652.22
09/15,Withdrawal Debit Card Visa Check...........................................  TACO BELL 037408 COLORADO SPRI CO 5814,-14.47,637.75
09/15,Withdrawal Home Banking Transfer To Share 11....................  REF# 63343298,-300.00,337.75
09/15,"Withdrawal Home Banking Transfer REF# 63343306..............  To MITCHELL,JUSTINE 532694 Share 11",-35.00,302.75
09/16,Withdrawal Debit Card Visa Check...........................................  SONIC DRIVE IN #5256 COLORADO SPRI CO 5814,-16.04,286.71
09/16,Withdrawal Debit Card Visa Check...........................................  KUM&GO 0667R CO SPRIN CO SPRINGS CO 5542,-49.22,237.49
09/16,Withdrawal POS #325916867579...........................................  COSTCO WHSE #1014 COLORADO SPRI CO 5300,-174.82,62.67
09/16,Withdrawal POS #326000217001...........................................  KING SOOPERS #01 9225 N COLORADO SPRI CO 5411,-9.98,52.69
09/17,09/16 Withdrawal Debit Card Visa Check...........................................  Amazon.com*TX2IU5EO0 Amzn.com/bill WA 5942,-25.00,27.69
09/17,Deposit Transfer From Share 00.............................................. ,48.34,76.03
09/17,Recurring Withdrawal Debit Card Visa Check..........................  KING SOOPERS #5119 866-576-4377 CO 5411,-76.03,0.00
09/18,Deposit Transfer From Share 00.............................................. ,8.98,8.98
09/18,Withdrawal Debit Card Visa Check...........................................  KUM&GO 0659R CO SPRIN CO SPRINGS CO 5541,-8.98,0.00
09/18,Deposit Transfer From Share 00.............................................. ,7.98,7.98
09/18,Withdrawal Debit Card Visa Check...........................................  Equal Housing Opportunity Ent is a registered trademark of Ent Credit Union Insured by NCUA AccountNumber 1159412 StatementPeriod09/01/23thru09/30/23 Page 7 of 11 1111111111111111111111010011001101110011001110011010100010010001010000000111010011000011101011000110000001100100001111100011000011011000100110000000011011000100100010100110010111001110000100111001010110010011111001010011101010100111000101001101101001011000100110111010111011001011010001011000110001110010001111010000111011001110110001101101011101110111111100010101101001010100100110011100001111011001111101100111001111010101010001111100100111110010001000101011010101010101010101010101 No Strings Checking - 10 NO STRINGS CHECKING (continued) TransDate EffDate TransactionDescription Amount Balance KUM&GO 0659R CO SPRIN CO SPRINGS CO 5541,-7.98,0.00
09/18,Deposit Home Banking Transfer From Share 00......................  REF# 63402504,175.00,175.00
09/19,Withdrawal Debit Card Visa Check...........................................  AMZN Mktp US*TX9SO2Q30 Amzn.com/bill WA 5942,-91.45,83.55
09/20,Withdrawal Debit Card Visa Check...........................................  VENMO* Visa Direct NY 4829,-15.00,68.55
09/20,Withdrawal Debit Card Visa Check...........................................  2574PEPSIVEN9147678600 COLORADO SPRI CO 5814,-3.10,65.45
09/21,Withdrawal Debit Card Visa Check...........................................  KUM&GO 0659R CO SPRIN CO SPRINGS CO 5541,-8.31,57.14
09/22,Deposit ACH Colorado Springs................................................  TYPE: PR PAYMENT CO: Colorado Springs,703.71,760.85
09/22,Withdrawal Home Banking Transfer To Share 11....................  REF# 63517005,-300.00,460.85
09/22,"Withdrawal Home Banking Transfer REF# 63517020..............  To MITCHELL,JUSTINE 532694 Share 11",-35.00,425.85
09/22,"Withdrawal Home Banking Transfer REF# 63517040..............  To MITCHELL,JUSTINE 532694 Share 01",-100.00,325.85
09/22,"Withdrawal Home Banking Transfer REF# 63517074..............  To MITCHELL,JUSTINE 532694 Share 12",-25.00,300.85
09/22,Withdrawal Debit Card Visa Check...........................................  PY *CHEBA HUT TOASTED S COLORADO SPIN CO 5812,-16.83,284.02
09/22,"Deposit Home Banking Transfer REF# 63528933....................  From MITCHELL,JUSTINE 532694 Share 00",108.00,392.02
09/22,Deposit Home Banking Transfer From Share 00......................  REF# 63528973,92.00,484.02
09/23,Withdrawal Debit Card Visa Check...........................................  VENMO* Visa Direct NY 4829,-10.00,474.02
09/23,Withdrawal POS #326600125494...........................................  Equal Housing Opportunity Ent is a registered trademark of Ent Credit Union Insured by NCUA 397475-1.38-66503N11.no7 029926803 4-6 AccountNumber 1159412 StatementPeriod09/01/23thru09/30/23 Page 8 of 11 No Strings Checking - 10 NO STRINGS CHECKING (continued) TransDate EffDate TransactionDescription Amount Balance KING SOOPERS #719 FUEL 9255 N UNION BL COLORADO SPRI CO 5542,-65.03,408.99
09/23,Withdrawal Debit Card Visa Check...........................................  AMZN Mktp US*TX0BM4DQ1 Amzn.com/bill WA 5942,-30.27,378.72
09/24,Withdrawal POS #326715864584...........................................  KING SOOPERS #01 9225 N COLORADO SPRI CO 5411,-57.65,321.07
09/24,Withdrawal POS #326712444545...........................................  COSTCO WHSE #1014 COLORADO SPRI CO 5300,-106.28,214.79
09/24,Withdrawal Debit Card Visa Check...........................................  PINE CREEK VETERINARY H COLORADO SPRI CO 0742,-140.48,74.31
09/24,Withdrawal Debit Card Visa Check...........................................  DUTCH BROS 541-955-4700 OR 5814,-10.00,64.31
09/25,Recurring Withdrawal Debit Card Visa Check..........................  KING SOOPERS #0119 877-415-4647 CO 5411,-5.84,58.47
09/25,Deposit ACH www.zola.com....................................................  TYPE: ZOLA WEDDI CO: www.zola.com,100.00,158.47
09/25,Withdrawal Debit Card Visa Check...........................................  KUM&GO 0667R CO SPRIN CO SPRINGS CO 5542,-40.80,117.67
09/25,Withdrawal Debit Card Visa Check...........................................  BUFF CITY SOAP - DUBLIN CHATTANOOGA TN 5099,-14.07,103.60
09/25,Withdrawal Debit Card Visa Check...........................................  WL *Steam Purchase 425-9522985 WA 5816,-41.22,62.38
09/28,Withdrawal Debit Card Visa Check...........................................  MCDONALDâ€™S F11078 COLORADO SPRI CO 5814,-3.13,59.25
09/28,Deposit Home Banking Transfer From Share 00......................  REF# 63683950,300.00,359.25
09/28,Withdrawal Debit Card Visa Check...........................................  PLAZA DELICATESSEN COLORADO SPRI CO 5814,-11.50,347.75
09/29,Deposit ACH UNIVERSITY OF CO............................................  TYPE: DIR DEP CO: UNIVERSITY OF CO,661.78,"1,009.53"
09/29,Withdrawal Home Banking Transfer To Share 11....................  REF# 63724684,-300.00,709.53
09/29,"Withdrawal Home Banking Transfer REF# 63724715..............  Equal Housing Opportunity Ent is a registered trademark of Ent Credit Union Insured by NCUA AccountNumber 1159412 StatementPeriod09/01/23thru09/30/23 Page 9 of 11 1111111111111111111111010011001101110101001110011010100010000001010000000111010011000011101011000110000001110100001111100011000000111000100110000000111101000100100010100101010111001110000100100101010110010011111000100011101010100111011101011100111001011000011100111110111011101101110011001000110010111110101111010000010100010011110001111111100111011101111011111110010100000101111001111100111010011101101011100110001111010100010010111100010111110110001001101011110101010101010101010101 No Strings Checking - 10 NO STRINGS CHECKING (continued) TransDate EffDate TransactionDescription Amount Balance To MITCHELL,JUSTINE 532694 Share 11",-35.00,674.53
09/29,"Withdrawal Home Banking Transfer REF# 63724730..............  To MITCHELL,JUSTINE 532694 Share 01",-50.00,624.53
09/29,"Deposit Home Banking Transfer..............................................  From MITCHELL,JUSTINE 532694 Share 10 REF# 63724877 VENMO",60.00,684.53
09/29,Withdrawal Debit Card Visa Check...........................................  KUM&GO 0659R CO SPRIN CO SPRINGS CO 5541,-4.99,679.54
09/30,Withdrawal Debit Card Visa Check...........................................  TARGET 00022210 COLORADO SPRI CO 5411,-16.21,663.33
09/30,Withdrawal Debit Card Visa Check...........................................  BARK&CO (BARKBOX) 855-338-2275 NY 5995,-10.51,652.82
09/30,Withdrawal POS #327400211977...........................................  7-ELEVEN 9171 E ARAPAHOE RD US GREENWOOD VIL CO 5541,-20.70,632.12
09/30,Withdrawal Debit Card Visa Check...........................................  IN-N-OUTCOLORADOSPRING COLORADO SPRI CO 5814,-16.61,615.51
09/30,"Deposit Dividend Tiered Rate..................................................  Annual Percentage Yield Earned 0.070% for period: 09/01/23 to 09/30/23 Ending Balance............................................................................. 615.52 Total for this period Total year-to-date Total Courtesy Pay (Overdraft) Fees $0.00 $0.00 Total Returned Item (Non Sufficient Funds) Fees $0.00 $30.00 The information above is provided to assist you in the management of your checking account. Month to Date (MTD) figures only include fees assessed during the current month. Year to Date (YTD) totals reflect the net fees assessed for the current year. Equal Housing Opportunity Ent is a registered trademark of Ent Credit Union Insured by NCUA 397475-1.38-66503N11.no7 029926803 5-6 AccountNumber 1159412 StatementPeriod09/01/23thru09/30/23 Page 10 of 11 No Strings Checking - 11 NO STRINGS CHECKING Dividends Earned YTD: 0.23 JointOwner:TYMITCHELL Beginning Balance + Deposits & Other Credits (6) - Checks Cleared (0) - Withdrawals & Other Debits (0) = Ending Balance $300.18 $1,500.05 $0.00 $0.00 $1,800.23 TransDate EffDate TransactionDescription Amount Balance Beginning Balance......................................................................... 300.18",0.01,615.52
09/01,Deposit Home Banking Transfer From Share 10......................  REF# 62924927,300.00,600.18
09/08,Deposit Home Banking Transfer From Share 10......................  REF# 63124063,300.00,900.18
09/15,Deposit Home Banking Transfer From Share 10......................  REF# 63343298,300.00,"1,200.18"
09/22,Deposit Home Banking Transfer From Share 10......................  REF# 63517005,300.00,"1,500.18"
09/29,Deposit Home Banking Transfer From Share 10......................  REF# 63724684,300.00,"1,800.18"
09/30,"Deposit Dividend Tiered Rate..................................................  Annual Percentage Yield Earned 0.060% for period: 09/01/23 to 09/30/23 Ending Balance............................................................................. 1,800.23 No Strings Checking - 12 NO STRINGS CHECKING Dividends Earned YTD: 0.01 JointOwner:TYMITCHELL Beginning Balance + Deposits & Other Credits (0) - Checks Cleared (0) - Withdrawals & Other Debits (0) = Ending Balance $0.00 $0.00 $0.00 $0.00 $0.00 TransDate EffDate TransactionDescription Amount Balance Beginning Balance......................................................................... 0.00 No Strings Checking - 13 NO STRINGS CHECKING Dividends Earned YTD: 0.02 JointOwner:TYMITCHELL Beginning Balance + Deposits & Other Credits (3) - Checks Cleared (0) - Withdrawals & Other Debits (1) = Ending Balance $75.00 $165.01 $0.00 $70.00 $170.01 TransDate EffDate TransactionDescription Amount Balance Beginning Balance......................................................................... 75.00",0.05,"1,800.23"
09/01,Deposit Home Banking Transfer From Share 10......................  REF# 62924945,90.00,165.00
09/06,Withdrawal Home Banking Transfer To Share 10....................  REF# 63044754,-70.00,95.00
09/08,Deposit Home Banking Transfer From Share 10......................  Equal Housing Opportunity Ent is a registered trademark of Ent Credit Union Insured by NCUA AccountNumber 1159412 StatementPeriod09/01/23thru09/30/23 Page 11 of 11 1111111111111111111111010001001101110111001110011010100010010001010000000111010011000011101011000110000001111100001111100011000010111000100110000000010111000100100010100111010111001110000100011011010110010011111001001111101010100111010001011100111001011000100010111110111011010111011111011000110000000010011111010000000000000110010001001110001000000101111011010000101100000101111101001111110000011010110110100111111011010111010001110100110111110110111001001011110101010101010101010101 No Strings Checking - 13 NO STRINGS CHECKING (continued) TransDate EffDate TransactionDescription Amount Balance REF# 63124079,75.00,170.00
09/30,"Deposit Dividend Tiered Rate..................................................  Annual Percentage Yield Earned 0.070% for period: 09/01/23 to 09/30/23 Ending Balance............................................................................. 170.01 YEAR-TO-DATE DIVIDEND SUMMARY Reportable Dividends this Year:............................................................................. 0.65 Reportable dividends of $10.00 or more are reported to the IRS as interest income for the year. ** The Visa Foreign Currency Transaction Fee will be assessed to purchases made outside of the United States as well as to online purchases made within the United States, but the merchant is located outside the United States. ** No-cost loan payment alternatives are available, please call 800-525-9623 for more information. Equal Housing Opportunity Ent is a registered trademark of Ent Credit Union Insured by NCUA 397475-1.38-66503N11.no7 029926803 6-6",0.01,170.01
