TransDate,TransactionDescription,Amount,Balance
08/04,Deposit ACH UNIVERSITY OF CO............................................  TYPE: DIR DEP CO: UNIVERSITY OF CO,216.86,223.10
08/06,Withdrawal Home Banking Transfer To Share 10....................  REF# 62131774,-120.00,103.10
08/07,Withdrawal Transfer To Share 10............................................ ,-66.38,36.72
08/07,Withdrawal Transfer To Share 10............................................ ,-12.97,23.75
08/08,Withdrawal Transfer To Share 10............................................  DEP PRENOTIFICATION FROM Colorado Springs,-15.41,8.34
08/10,Withdrawal Transfer To Share 10............................................ ,-3.34,5.00
08/10,"Deposit Home Banking Transfer REF# 62237311....................  From HODGES,JUSTINE B 532694 Share 00",100.00,105.00
08/10,Withdrawal Home Banking Transfer To Share 10....................  REF# 62244036,-90.00,15.00
08/18,Deposit ACH UNIVERSITY OF CO............................................  TYPE: DIR DEP CO: UNIVERSITY OF CO,233.24,248.24
08/20,Deposit at ATM #000000007422.............................................  ENT CREDIT UNION 7020 CAMPUS DRIVE Equal Housing Opportunity Ent is a registered trademark of Ent Credit Union Insured by NCUA AccountNumber 1159412 StatementPeriod08/01/23thru08/31/23 Page 2 of 13 Primary Savings - 00 PRIMARY SAVINGS (continued) TransDate EffDate TransactionDescription Amount Balance COLORADO SPRI CO,"1,225.00","1,473.24"
08/20,Deposit at ATM #000000007423.............................................  ENT CREDIT UNION 7020 CAMPUS DRIVE COLORADO SPRI CO,"1,630.00","3,103.24"
08/21,Withdrawal Home Banking Transfer To Share 10....................  REF# 62561047,-160.00,"2,943.24"
08/21,Withdrawal Home Banking Transfer To Share 10....................  REF# 62561103,-25.00,"2,918.24"
08/23,"Withdrawal Home Banking Transfer REF# 62611037..............  To HODGES,JUSTINE B 532694 Share 00",-500.00,"2,418.24"
08/23,Withdrawal Home Banking Transfer To Share 10....................  REF# 62611048,-350.00,"2,068.24"
08/24,Withdrawal Home Banking Transfer To Share 10....................  REF# 62642305,-130.00,"1,938.24"
08/24,Withdrawal Home Banking Transfer To Share 10....................  REF# 62651577,-215.00,"1,723.24"
08/25,Deposit ACH Colorado Springs................................................  TYPE: PR PAYMENT CO: Colorado Springs,113.47,"1,836.71"
08/26,Withdrawal Home Banking Transfer To Share 10....................  REF# 62713024,-600.00,"1,236.71"
08/27,Withdrawal Home Banking Transfer To Share 10....................  REF# 62734632,-200.00,"1,036.71"
08/31,"Deposit Dividend 0.050%........................................................  Annual Percentage Yield Earned 0.050% for period: 08/01/23 to 08/31/23 Ending Balance............................................................................. 1,036.74 No Strings Checking - 10 NO STRINGS CHECKING Dividends Earned YTD: 0.05 JointOwner:TYMITCHELL Beginning Balance + Deposits & Other Credits (33) - Checks Cleared (0) - Withdrawals & Other Debits (110)= Ending Balance $150.42 $7,706.54 $0.00 $7,759.04 $97.92 TransDate EffDate TransactionDescription Amount Balance Beginning Balance......................................................................... 150.42",0.03,"1,036.74"
08/01,"Deposit Home Banking Transfer REF# 61951582....................  From HODGES,JUSTINE B 532694 Share 10",57.00,207.42
08/01,"Deposit Home Banking Transfer REF# 61951681....................  Equal Housing Opportunity Ent is a registered trademark of Ent Credit Union Insured by NCUA AccountNumber 1159412 StatementPeriod08/01/23thru08/31/23 Page 3 of 13 1111111111111111111111010011001100110111001110011000100010000001110000001101110011000001101011100010000001111100001111100011000011011000100110000000111111000101110010100100110111001010000100110101010101000011111011101011111010000111000000001100100101011011100011111110000011111100010011011100110011000001011111001000101011001110010000001100001100000111111010011001011110100101111010010010110010011110101101101001100111001011010000001100100111000110001000001010110101010101010101010101 No Strings Checking - 10 NO STRINGS CHECKING (continued) TransDate EffDate TransactionDescription Amount Balance From HODGES,JUSTINE B 532694 Share 00",59.30,266.72
08/01,Withdrawal Adjustment Debit Card Credit Voucher.................  BOOTBARN.COM 888-440-2668 CA 5661,309.66,576.38
08/02,Withdrawal Debit Card Visa Check...........................................  AMZN Mktp US*TH6BW6D10 Amzn.com/bill WA 5942,-203.65,372.73
08/02,Withdrawal Debit Card Visa Check...........................................  AMZN Mktp US*TH7MR6D90 Amzn.com/bill WA 5942,-8.65,364.08
08/02,Withdrawal Home Banking Transfer To Share 11....................  REF# 61993259,-200.00,164.08
08/02,Recurring Withdrawal #321421106093...................................  Audible*TH6FO2M21 Amzn.com/bill NJ,-16.18,147.90
08/03,Withdrawal Debit Card Visa Check...........................................  McDonalds 26480 COLORADO SPRI CO 5814,-3.33,144.57
08/03,Withdrawal Debit Card Visa Check...........................................  2574PEPSIVEN9147678600 COLORADO SPRI CO 5814,-3.10,141.47
08/03,Recurring Withdrawal Debit Card Visa Check..........................  APPLE.COM/BILL 866-712-7753 CA 5818,-0.99,140.48
08/03,Withdrawal Debit Card Visa Check...........................................  KUM&GO 0659R CO SPRIN CO SPRINGS CO 5541,-7.46,133.02
08/03,"Deposit Home Banking Transfer REF# 62036259....................  From HODGES,JUSTINE B 532694 Share 00",275.00,408.02
08/04,Deposit ACH UNIVERSITY OF CO............................................  TYPE: DIR DEP CO: UNIVERSITY OF CO,867.46,"1,275.48"
08/04,Withdrawal Home Banking Transfer To Share 11....................  REF# 62069132,-300.00,975.48
08/04,"Withdrawal Home Banking Transfer REF# 62069143..............  To HODGES,JUSTINE B 532694 Share 01",-100.00,875.48
08/04,"Withdrawal Home Banking Transfer REF# 62069166..............  To HODGES,JUSTINE B 532694 Share 11 Equal Housing Opportunity Ent is a registered trademark of Ent Credit Union Insured by NCUA 397914-1.58-51407N11.no7 029314349 2-7 AccountNumber 1159412 StatementPeriod08/01/23thru08/31/23 Page 4 of 13 No Strings Checking - 10 NO STRINGS CHECKING (continued) TransDate EffDate TransactionDescription Amount Balance",-35.00,840.48
08/04,"Withdrawal Home Banking Transfer REF# 62069186..............  To HODGES,JUSTINE B 532694 Share 12",-100.00,740.48
08/04,Withdrawal Home Banking Transfer To Share 13....................  REF# 62069205,-140.00,600.48
08/05,Withdrawal Debit Card Visa Check...........................................  VENMO* Visa Direct NY 4829,-15.00,585.48
08/05,Withdrawal Debit Card Visa Check...........................................  CHICK-FIL-A #02342 COLO SPGS CO 5814,-18.48,567.00
08/06,Withdrawal Debit Card Visa Check...........................................  MENS WEARHOUSE #1307 COLORADO SPRI CO 5611,-65.40,501.60
08/06,Withdrawal Debit Card Visa Check...........................................  BAD DADDYâ€™S BURGER BAR COLORADO SPRI CO 5812,-57.00,444.60
08/06,Withdrawal POS #321815699849...........................................  COSTCO WHSE #1014 COLORADO SPRI CO 5300,-104.43,340.17
08/06,Withdrawal POS #321819427209...........................................  KING SOOPERS #01 9225 N COLORADO SPRI CO 5411,-121.26,218.91
08/06,Withdrawal Debit Card Visa Check...........................................  AMZN Mktp US*TA8UX4E40 Amzn.com/bill WA 5942,-141.42,77.49
08/06,Deposit Home Banking Transfer From Share 00......................  REF# 62131774,120.00,197.49
08/06,Withdrawal Debit Card Visa Check...........................................  LEVELUPSMOOTHIEKING26 855-466-5585 MA 5812,-21.06,176.43
08/07,08/06 Withdrawal Debit Card Visa Check...........................................  GARDEN OF THE GODS LIQU COLORADO SPRI CO 5921,-22.59,153.84
08/07,Withdrawal Debit Card Visa Check...........................................  Amazon.com*TA3GE9HQ2 Amzn.com/bill WA 5942,-94.36,59.48
08/07,Recurring Withdrawal Debit Card Visa Check..........................  COOKBOOK MOUNT COOLUM AU 5817,-1.49,57.99
08/07,Recurring Withdrawal Card Fee...............................................  VISA INTERNATIONAL SERVICE ASSESSMENT Date 08/07/23 W/D PRENOTIFICATION FROM SAFECO INSURANCE,-0.01,57.98
08/07,Withdrawal NSF Fee.................................................................  In the amount $275.00 SAFECO INS. CO.,-30.00,27.98
08/07,Deposit Transfer From Share 00..............................................  Equal Housing Opportunity Ent is a registered trademark of Ent Credit Union Insured by NCUA AccountNumber 1159412 StatementPeriod08/01/23thru08/31/23 Page 5 of 13 1111111111111111111111010011001100110001001110011000100010000001110000001101110011000001101011100010000001000100001111100011000000111000100110000000010001000101110010100111110111001010000100110001010101000011111011110111111010000111010011011101100101011011010111111010000011110100100001001100110000111111011111001000001000010011010000001101111011010111111010110101000100000101010010000100100110011100110110011100100111000110110001011100110111000110001000101011010101010101010101010101 No Strings Checking - 10 NO STRINGS CHECKING (continued) TransDate EffDate TransactionDescription Amount Balance,66.38,94.36
08/07,Withdrawal Debit Card Visa Check...........................................  Amazon.com*TA5T87TQ1 Amzn.com/bill WA 5942,-94.36,0.00
08/07,Deposit Transfer From Share 00.............................................. ,12.97,12.97
08/07,Withdrawal POS #321921031047...........................................  PETCO 1472 COLORADO SPRI CO 5995,-12.97,0.00
08/08,Deposit Transfer From Share 00.............................................. ,15.41,15.41
08/08,Withdrawal Debit Card Visa Check...........................................  TARGET 00022210 COLORADO SPRI CO 5411,-15.41,0.00
08/08,"Deposit Home Banking Transfer REF# 62179031....................  From HODGES,JUSTINE B 532694 Share 00",50.00,50.00
08/08,Deposit Home Banking Transfer From Share 13......................  REF# 62191909,75.00,125.00
08/09,Withdrawal Debit Card Visa Check...........................................  AMZN Mktp US*TA0RF85F1 Amzn.com/bill WA 5942,-21.88,103.12
08/09,Withdrawal Debit Card Visa Check...........................................  CO E-GOV SERVICES EMV 303-534-3468 CO 9399,-2.50,100.62
08/09,"Deposit Home Banking Transfer REF# 62204653....................  From HODGES,JUSTINE B 532694 Loan 01",300.00,400.62
08/09,Withdrawal Debit Card Visa Check...........................................  AMZN Mktp US*TA75J5I52 Amzn.com/bill WA 5942,-7.73,392.89
08/09,Withdrawal Debit Card Visa Check...........................................  KUM&GO 0659R CO SPRIN CO SPRINGS CO 5542,-70.02,322.87
08/09,Withdrawal Debit Card Visa Check...........................................  SQ *K BARBER NEXT LEVEL Colorado Spri CO 7230,-40.50,282.37
08/09,Withdrawal Debit Card Visa Check...........................................  VENMO* Visa Direct NY 4829,-100.00,182.37
08/09,Withdrawal Debit Card Visa Check...........................................  PP*DUTCHBROSLL GRANTS PASS OR 5499,-14.05,168.32
08/10,08/09 Withdrawal Debit Card Visa Check...........................................  PRICELN*COURTYARD BY M 203-299-8000 CT 4722 Equal Housing Opportunity Ent is a registered trademark of Ent Credit Union Insured by NCUA 397914-1.58-51407N11.no7 029314349 3-7 AccountNumber 1159412 StatementPeriod08/01/23thru08/31/23 Page 6 of 13 No Strings Checking - 10 NO STRINGS CHECKING (continued) TransDate EffDate TransactionDescription Amount Balance,-139.70,28.62
08/10,Deposit Transfer From Share 00..............................................  KUM&GO 0667R CO SPRIN CO SPRINGS CO 5542,3.34,31.96
08/10,Deposit Home Banking Transfer From Share 13......................  REF# 62237470,65.00,56.96
08/10,Withdrawal Debit Card Visa Check...........................................  ULTA #779 COLORADO SPRI CO 5977,-47.95,9.01
08/10,Deposit Home Banking Transfer From Share 00......................  REF# 62244036,90.00,99.01
08/10,"Deposit Home Banking Transfer REF# 62246273....................  From HODGES,JUSTINE B 532694 Share 00",50.00,149.01
08/11,Withdrawal Debit Card Visa Check...........................................  SUMUP *TENACIOUS SPRAY COLORADO SPRI CO 7230,-86.25,62.76
08/11,Withdrawal Debit Card Visa Check...........................................  CO DRIVER SERVICES DENVER CO 9399,-32.33,30.43
08/11,Deposit ACH Colorado Springs................................................  TYPE: PR PAYMENT CO: Colorado Springs,"1,318.98","1,349.41"
08/11,Withdrawal Home Banking Transfer To Share 11....................  REF# 62265767,-300.00,"1,049.41"
08/11,Withdrawal Home Banking Transfer To Share 13....................  REF# 62265789,-160.00,889.41
08/11,"Withdrawal Home Banking Transfer REF# 62265931..............  To HODGES,JUSTINE B 532694 Share 11",-70.00,819.41
08/11,"Withdrawal Home Banking Transfer REF# 62265952..............  To HODGES,JUSTINE B 532694 Share 01",-150.00,669.41
08/11,"Withdrawal Home Banking Transfer REF# 62266000..............  To HODGES,JUSTINE B 532694 Share 12",-100.00,569.41
08/11,Withdrawal Debit Card Visa Check...........................................  TARGET 00015016 COLORADO SPRI CO 5411,-16.73,552.68
08/11,Recurring Withdrawal #322320700689...................................  ADOBE CREATIVE CLOUD 408-536-6000 CA,-20.60,532.08
08/11,Withdrawal Debit Card Visa Check...........................................  2574PEPSIVEN9147678600 COLORADO SPRI CO 5814,-3.10,528.98
08/12,Withdrawal Debit Card Visa Check...........................................  Equal Housing Opportunity Ent is a registered trademark of Ent Credit Union Insured by NCUA AccountNumber 1159412 StatementPeriod08/01/23thru08/31/23 Page 7 of 13 1111111111111111111111010011001100110011001110011000100010010001110000001101110011000001101011100010000001001100001111100011000010011000100110000000010001000101110010100101010111001010000100011111010101000011111001101011111010000111110000011101100101011001011111111010000011101000011111011100110011000011011111001000001101001011110001011110101010001111111111101111111111000100000011111001110111011000110101001100011111001010010010010100110111000010001001001011010101010101010101010101 No Strings Checking - 10 NO STRINGS CHECKING (continued) TransDate EffDate TransactionDescription Amount Balance ULTA #133 COLORADO SPRI CO 5977,-32.46,496.52
08/12,Withdrawal Debit Card Visa Check...........................................  IN N OUT BURGER 359 COLORADO SPRI CO 5814,-14.31,482.21
08/13,Withdrawal POS #322500936784...........................................  SEI 33042 8750 S YOSEMITE US LONE TREE CO 5542,-74.05,408.16
08/14,Recurring Withdrawal #322610607420...................................  8667127753 APPLE COM BILL CUPERTINO CA,-15.99,392.17
08/14,Withdrawal POS #322617831031...........................................  KING SOOPERS #01 9225 N COLORADO SPRI CO 5411,-7.43,384.74
08/14,Withdrawal POS #322614660112...........................................  COSTCO WHSE #1014 COLORADO SPRI CO 5300,-151.88,232.86
08/14,Withdrawal Debit Card Visa Check...........................................  BJS RESTAURANTS 502 COLORADO SPRI CO 5812 Amazon.com Pending credit/return for $94.08 on card 0950 Amazon.com Pending credit/return for $94.08 on card 0950,-32.00,200.86
08/14,Withdrawal Adjustment Debit Card Credit Voucher.................  Amazon.com Amzn.com/bill WA 5942,94.08,294.94
08/14,Withdrawal Adjustment Debit Card Credit Voucher.................  Amazon.com Amzn.com/bill WA 5942,94.08,389.02
08/14,Recurring Withdrawal Debit Card Visa Check..........................  APPLE.COM/BILL 866-712-7753 CA 5818,-0.99,388.03
08/15,Withdrawal Debit Card Visa Check...........................................  SCHEELS COLORADO SPRING COLORADO SPRI CO 5941,-58.05,329.98
08/15,Withdrawal Debit Card Visa Check...........................................  KUM&GO 0659R CO SPRIN CO SPRINGS CO 5541,-6.23,323.75
08/15,Recurring Withdrawal Debit Card Visa Check..........................  KING SOOPERS #5119 866-576-4377 CO 5411,-52.13,271.62
08/15,Withdrawal Debit Card Visa Check...........................................  Equal Housing Opportunity Ent is a registered trademark of Ent Credit Union Insured by NCUA 397914-1.58-51407N11.no7 029314349 4-7 AccountNumber 1159412 StatementPeriod08/01/23thru08/31/23 Page 8 of 13 No Strings Checking - 10 NO STRINGS CHECKING (continued) TransDate EffDate TransactionDescription Amount Balance RAISING CANES 0403 COLORADO SPRI CO 5814,-18.94,252.68
08/15,Withdrawal Debit Card Visa Check...........................................  SQ *LUMPIA HOUSE LLC Colorado Spri CO 5814,-13.55,239.13
08/16,"Deposit Home Banking Transfer REF# 62410598....................  From HODGES,JUSTINE B 532694 Share 00",172.00,411.13
08/16,Withdrawal Debit Card Visa Check...........................................  2574PEPSIVEN9147678600 COLORADO SPRI CO 5814,-3.10,408.03
08/18,Deposit ACH UNIVERSITY OF CO............................................  TYPE: DIR DEP CO: UNIVERSITY OF CO,932.94,"1,340.97"
08/18,Withdrawal Home Banking Transfer To Share 11....................  REF# 62464997,-300.00,"1,040.97"
08/18,"Withdrawal Home Banking Transfer REF# 62465057..............  To HODGES,JUSTINE B 532694 Share 11",-35.00,"1,005.97"
08/18,"Withdrawal Home Banking Transfer REF# 62465073..............  To HODGES,JUSTINE B 532694 Share 01",-100.00,905.97
08/18,"Withdrawal Home Banking Transfer REF# 62465075..............  To HODGES,JUSTINE B 532694 Share 12 AMZN Mktp US Pending credit/return for $94.08 on card 0950",-100.00,805.97
08/18,Withdrawal Adjustment Debit Card Credit Voucher.................  AMZN Mktp US Amzn.com/bill WA 5942,94.08,900.05
08/19,Withdrawal POS #323115711152...........................................  KING SOOPERS #01 9225 N COLORADO SPRI CO 5411,-31.37,868.68
08/19,Withdrawal Debit Card Visa Check...........................................  crypto.com Miami FL 6051,-370.65,498.03
08/20,Withdrawal Debit Card Visa Check...........................................  SP TRUECLASSICTEES.C HTTPSTRUECLAS CA 5611,-130.33,367.70
08/20,Withdrawal POS #323200116086...........................................  KING SOOPERS #719 FUEL 9255 N UNION BL COLORADO SPRI CO 5542,-64.76,302.94
08/20,Withdrawal POS #323213832536...........................................  COSTCO WHSE #1014 COLORADO SPRI CO 5300,-109.20,193.74
08/20,Withdrawal POS #323220528080...........................................  KING SOOPERS #01 9225 N COLORADO SPRI CO 5411 Equal Housing Opportunity Ent is a registered trademark of Ent Credit Union Insured by NCUA AccountNumber 1159412 StatementPeriod08/01/23thru08/31/23 Page 9 of 13 1111111111111111111111010011001100110101001110011000100010000001110000001101110011000001101011100010000001101100001111100011000000111000100110000000111101000101110010100110010111001010000100001001010101000011111011001011111010000111101000011101100101011010011010111110000011001011100111001100110011100111110111001000111101000011110001101101011010000111111010101101010111100100100100111111101000011111111011101110000111000011110000000100010111000110001000101011110101010101010101010101 No Strings Checking - 10 NO STRINGS CHECKING (continued) TransDate EffDate TransactionDescription Amount Balance,-45.22,148.52
08/21,Withdrawal Debit Card Visa Check...........................................  KUM&GO 0659R CO SPRIN CO SPRINGS CO 5541,-15.22,133.30
08/21,Recurring Withdrawal Debit Card Visa Check..........................  KING SOOPERS #5119 866-576-4377 CO 5411,-83.98,49.32
08/21,Deposit Home Banking Transfer From Share 00......................  REF# 62561047,160.00,209.32
08/21,Deposit Home Banking Transfer From Share 00......................  REF# 62561103,25.00,234.32
08/21,Deposit Home Banking Transfer From Share 13......................  REF# 62562789,85.00,319.32
08/21,Withdrawal POS #323300126576...........................................  KING SOOPERS #719 FUEL 9255 N UNION BL COLORADO SPRI CO 5542,-77.64,241.68
08/22,Withdrawal Debit Card Visa Check...........................................  2574PEPSIVEN9147678600 COLORADO SPRI CO 5814,-3.10,238.58
08/23,Withdrawal Debit Card Visa Check...........................................  AMZN Mktp US*TQ58I0QG0 Amzn.com/bill WA 5942,-199.22,39.36
08/23,Withdrawal Debit Card Visa Check...........................................  VENMO* Visa Direct NY 4829,-15.00,24.36
08/23,Deposit Home Banking Transfer From Share 00......................  REF# 62611048,350.00,374.36
08/23,Withdrawal POS #323500415517...........................................  TJMAXX #0251 3999 PALMER PARK BLVD. COLORADO SPRI CO 5310,-51.89,322.47
08/24,Withdrawal Debit Card Visa Check...........................................  KUM&GO 0659R CO SPRIN CO SPRINGS CO 5541,-11.27,311.20
08/24,Withdrawal Debit Card Visa Check...........................................  BUFF CITY SOAP - DUBLIN COLORADO SPRI CO 5099,-41.68,269.52
08/24,Withdrawal Debit Card Visa Check...........................................  PLATOâ€™S CLOSET COLORADO SPRI CO 5931,-61.66,207.86
08/24,Deposit Home Banking Transfer From Share 00......................  Equal Housing Opportunity Ent is a registered trademark of Ent Credit Union Insured by NCUA 397914-1.58-51407N11.no7 029314349 5-7 AccountNumber 1159412 StatementPeriod08/01/23thru08/31/23 Page 10 of 13 No Strings Checking - 10 NO STRINGS CHECKING (continued) TransDate EffDate TransactionDescription Amount Balance REF# 62642305,130.00,337.86
08/24,Deposit Home Banking Transfer From Share 00......................  REF# 62651577,215.00,552.86
08/24,Withdrawal Debit Card Visa Check...........................................  CHICK-FIL-A #03985 COLORADO SPRI CO 5814,-10.44,542.42
08/25,Withdrawal Debit Card Visa Check...........................................  APPLE.COM/BILL 866-712-7753 CA 5818,-64.87,477.55
08/25,Withdrawal Debit Card Visa Check...........................................  IK MULTIMEDIA US LLC 9548469101 FL 5732,-216.39,261.16
08/25,Withdrawal Debit Card Visa Check...........................................  GUITARCENTER.COM INTERN 866-498-7882 CA 5733,-140.65,120.51
08/25,Deposit ACH Colorado Springs................................................  TYPE: PR PAYMENT CO: Colorado Springs,605.23,725.74
08/25,Withdrawal Debit Card Visa Check...........................................  CHEBA HUT- COLORADO SPR COLORADO SPRI CO 5812,-29.74,696.00
08/25,Withdrawal Debit Card Visa Check...........................................  CHEBA HUT- COLORADO SPR COLORADO SPRI CO 5812,-3.26,692.74
08/25,Withdrawal Home Banking Transfer To Share 11....................  REF# 62681663,-300.00,392.74
08/25,Withdrawal POS #323800833669...........................................  KING SOOPERS #01 9225 N COLORADO SPRI CO 5411,-8.78,383.96
08/25,Withdrawal Debit Card Visa Check...........................................  VENMO* Visa Direct NY 4829,-18.00,365.96
08/26,Withdrawal Debit Card Visa Check...........................................  AMZN Mktp US*T30ZT3Z50 Amzn.com/bill WA 5942,-10.01,355.95
08/26,Deposit Home Banking Transfer From Share 00......................  REF# 62713024,600.00,955.95
08/26,Withdrawal Debit Card Visa Check...........................................  RAISING CANES 0403 COLORADO SPRI CO 5814,-12.66,943.29
08/27,Withdrawal Debit Card Visa Check...........................................  SCHEELS COLORADO SPRING COLORADO SPRI CO 5941,-516.05,427.24
08/27,Withdrawal Debit Card Visa Check...........................................  DUTCH BROS 541-955-4700 OR 5814 Equal Housing Opportunity Ent is a registered trademark of Ent Credit Union Insured by NCUA AccountNumber 1159412 StatementPeriod08/01/23thru08/31/23 Page 11 of 13 1111111111111111111111010011001100110111001110011000100010010001110000001101110011000001101011100010000001100100001111100011000010011000100110000000111101000101110010100100110111001010000100100111010101000011111001010111111010000111001011011101100101011000010010111110000011010111011001011100110000011011110111001000111000011011010000111110001011011111111111110111101100100101110101000010111001011011111000111110111111001111010011001100010111000010001001001011110101010101010101010101 No Strings Checking - 10 NO STRINGS CHECKING (continued) TransDate EffDate TransactionDescription Amount Balance,-10.00,417.24
08/27,Withdrawal Debit Card Visa Check...........................................  TACO BELL 037416 COLORADO SPRI CO 5814 SCHEELS COLORADO SPRING Pending credit/return for $213.62 on card 0950,-10.87,406.37
08/27,Deposit Home Banking Transfer From Share 00......................  REF# 62734632,200.00,606.37
08/27,Withdrawal POS #323918639992...........................................  COSTCO WHSE #1014 COLORADO SPRI CO 5300,-127.08,479.29
08/27,Withdrawal Debit Card Visa Check...........................................  DUTCH BROS 541-955-4700 OR 5814,-10.00,469.29
08/27,Withdrawal Debit Card Visa Check...........................................  POSHMARK 650-488-7740 CA 5931,-35.56,433.73
08/28,Withdrawal Adjustment Debit Card Credit Voucher.................  SCHEELS COLORADO SPRING COLORADO SPRI CO 5941,213.62,647.35
08/28,Withdrawal Debit Card Visa Check...........................................  SCHEELS COLORADO SPRING COLORADO SPRI CO 5941,-210.34,437.01
08/28,Withdrawal POS #324000117257...........................................  KING SOOPERS #719 FUEL 9255 N UNION BL COLORADO SPRI CO 5542,-70.58,366.43
08/28,Withdrawal Debit Card Visa Check...........................................  TACO BELL 037413 COLORADO SPRI CO 5814,-16.44,349.99
08/28,Withdrawal POS #324013343815...........................................  MURPHY EXPRESS 8984 COLORADO SPRI CO 5541,-2.89,347.10
08/28,Withdrawal Debit Card Visa Check...........................................  SP JIV ATHLETICS HTTPSJIVATHLE CA 5699,-68.40,278.70
08/28,Recurring Withdrawal Debit Card Visa Check..........................  KING SOOPERS #5119 866-576-4377 CO 5411,-65.31,213.39
08/28,Withdrawal Debit Card Visa Check...........................................  KUM&GO 0667R CO SPRIN CO SPRINGS CO 5541,-7.57,205.82
08/30,Withdrawal Debit Card Visa Check...........................................  POSHMARK 650-488-7740 CA 5931,-94.81,111.01
08/30,Withdrawal Debit Card Visa Check...........................................  Equal Housing Opportunity Ent is a registered trademark of Ent Credit Union Insured by NCUA 397914-1.58-51407N11.no7 029314349 6-7 AccountNumber 1159412 StatementPeriod08/01/23thru08/31/23 Page 12 of 13 No Strings Checking - 10 NO STRINGS CHECKING (continued) TransDate EffDate TransactionDescription Amount Balance DUTCH BROS 541-955-4700 OR 5814,-10.00,101.01
08/31,Withdrawal Debit Card Visa Check...........................................  2574PEPSIVEN9147678600 COLORADO SPRI CO 5814,-3.10,97.91
08/31,"Deposit Dividend Tiered Rate..................................................  Annual Percentage Yield Earned 0.030% for period: 08/01/23 to 08/31/23 Ending Balance............................................................................. 97.92 Total for this period Total year-to-date Total Courtesy Pay (Overdraft) Fees $0.00 $0.00 Total Returned Item (Non Sufficient Funds) Fees $30.00 $30.00 The information above is provided to assist you in the management of your checking account. Month to Date (MTD) figures only include fees assessed during the current month. Year to Date (YTD) totals reflect the net fees assessed for the current year. No Strings Checking - 11 NO STRINGS CHECKING Dividends Earned YTD: 0.18 JointOwner:TYMITCHELL Beginning Balance + Deposits & Other Credits (6) - Checks Cleared (0) - Withdrawals & Other Debits (1) = Ending Balance $100.14 $1,400.04 $0.00 $1,200.00 $300.18 TransDate EffDate TransactionDescription Amount Balance Beginning Balance......................................................................... 100.14",0.01,97.92
08/02,Deposit Home Banking Transfer From Share 10......................  REF# 61993259,200.00,300.14
08/04,Deposit Home Banking Transfer From Share 10......................  REF# 62069132,300.00,600.14
08/11,Deposit Home Banking Transfer From Share 10......................  REF# 62265767,300.00,900.14
08/18,Deposit Home Banking Transfer From Share 10......................  REF# 62464997,300.00,"1,200.14"
08/25,Deposit Home Banking Transfer From Share 10......................  REF# 62681663,300.00,"1,500.14"
08/30,Withdrawal Home Banking......................................................  ACH WITHDRAWAL US BANK NA - JUSTINE HODGES,"-1,200.00",300.14
08/31,Deposit Dividend Tiered Rate..................................................  Annual Percentage Yield Earned 0.050% for period: 08/01/23 to 08/31/23 Ending Balance............................................................................. 300.18 Equal Housing Opportunity Ent is a registered trademark of Ent Credit Union Insured by NCUA AccountNumber 1159412 StatementPeriod08/01/23thru08/31/23 Page 13 of 13 1111111111111111111111010001001100111001001110011000100010010001110000001101110011000001101011100010000001101100001111100011000010011000100110000000010101000101110010100110010111001010000100010001010101000011111010001011111010000111011101101100100101011010001100111010000011100000111001001100110000011010010111001000100000101100110001101100111111001111111100100100100001000101101101001001011001111001110001010011100011001000010000110100100111000100111000101010010101010101010101010101 No Strings Checking - 12 NO STRINGS CHECKING Dividends Earned YTD: 0.01 JointOwner:TYMITCHELL Beginning Balance + Deposits & Other Credits (0) - Checks Cleared (0) - Withdrawals & Other Debits (0) = Ending Balance $0.00 $0.00 $0.00 $0.00 $0.00 TransDate EffDate TransactionDescription Amount Balance Beginning Balance......................................................................... 0.00 Ending Balance............................................................................. 0.00 No Strings Checking - 13 NO STRINGS CHECKING Dividends Earned YTD: 0.01 JointOwner:TYMITCHELL Beginning Balance + Deposits & Other Credits (2) - Checks Cleared (0) - Withdrawals & Other Debits (3) = Ending Balance $0.00 $300.00 $0.00 $225.00 $75.00 TransDate EffDate TransactionDescription Amount Balance Beginning Balance......................................................................... 0.00,0.04,300.18
08/04,Deposit Home Banking Transfer From Share 10......................  REF# 62069205,140.00,140.00
08/08,Withdrawal Home Banking Transfer To Share 10....................  REF# 62191909,-75.00,65.00
08/10,Withdrawal Home Banking Transfer To Share 10....................  REF# 62237470,-65.00,0.00
08/11,Deposit Home Banking Transfer From Share 10......................  REF# 62265789,160.00,160.00
08/21,"Withdrawal Home Banking Transfer To Share 10....................  REF# 62562789 Ending Balance............................................................................. 75.00 YEAR-TO-DATE DIVIDEND SUMMARY Reportable Dividends this Year:............................................................................. 0.54 Reportable dividends of $10.00 or more are reported to the IRS as interest income for the year. ** The Visa Foreign Currency Transaction Fee will be assessed to purchases made outside of the United States as well as to online purchases made within the United States, but the merchant is located outside the United States. ** No-cost loan payment alternatives are available, please call 800-525-9623 for more information. Equal Housing Opportunity Ent is a registered trademark of Ent Credit Union Insured by NCUA 397914-1.58-51407N11.no7 029314349 7-7",-85.00,75.00
04/04,"Deposit Home Banking Transfer REF# 58451743....................  From HODGES,JUSTINE B 532694 Share 10",100.00,"1,735.26"
04/05,Withdrawal Home Banking Transfer To Share 10....................  REF# 58457972,-200.00,"1,535.26"
04/06,Deposit Home Banking Transfer From Share 10......................  REF# 58489900,75.00,"1,610.26"
04/14,Deposit ACH UNIVERSITY OF CO............................................  TYPE: DIR DEP CO: UNIVERSITY OF CO,156.89,"1,767.15"
04/28,Deposit ACH UNIVERSITY OF CO............................................  TYPE: DIR DEP CO: UNIVERSITY OF CO DEP PRENOTIFICATION FROM UNIVERSITY OF CO,147.65,"1,914.80"
04/30,"Deposit Dividend 0.050%........................................................  Annual Percentage Yield Earned 0.050% for period: 04/01/23 to 04/30/23 Ending Balance............................................................................. 1,914.87 Equal Housing Opportunity Ent is a registered trademark of Ent Credit Union Insured by NCUA AccountNumber 1159412 StatementPeriod04/01/23thru04/30/23 Page 2 of 10 No Strings Checking - 10 NO STRINGS CHECKING Dividends Earned YTD: 0.01 JointOwner:TYMITCHELL Beginning Balance + Deposits & Other Credits (10) - Checks Cleared (0) - Withdrawals & Other Debits (107)= Ending Balance $1,114.39 $2,988.06 $0.00 $3,850.30 $252.15 TransDate EffDate TransactionDescription Amount Balance Beginning Balance......................................................................... 1,114.39",0.07,"1,914.87"
04/01,Withdrawal Debit Card Visa Check...........................................  JIMMY JOHNS - 2924 COLORADO SPRI CO 5814,-9.97,"1,104.42"
04/01,Withdrawal Debit Card Visa Check...........................................  AMZN Mktp US*HY0X86PQ2 Amzn.com/bill WA 5942,-33.79,"1,070.63"
04/01,Withdrawal Debit Card Visa Check...........................................  KUM&GO 0667R CO SPRIN CO SPRINGS CO 5542,-30.05,"1,040.58"
04/02,"04/01 Withdrawal Home Banking Transfer REF# 58361174..............  To HODGES,JUSTINE B 532694 Share 10",-15.00,"1,025.58"
04/02,Withdrawal Debit Card Visa Check...........................................  FUZZYS TACO SHOP COLORA TIMNATH CO 5812,-32.00,993.58
04/02,Withdrawal Debit Card Visa Check...........................................  PANDA EXPRESS #3558 FALCON CO 5814,-11.67,981.91
04/02,Withdrawal POS #309212425631...........................................  COSTCO WHSE #1030 COLORADO SPG CO 5300,-101.38,880.53
04/02,Withdrawal POS #309216843545...........................................  AUTOZONE 3434 690 W GA COLORADO SPRI CO 5533,-19.34,861.19
04/02,Withdrawal POS #309217088010...........................................  CIRCLE K 09847 COLORADO SPRN CO 5541,-6.23,854.96
04/03,Withdrawal POS #309312399643...........................................  CIRCLE K 09847 COLORADO SPRN CO 5541,-6.48,848.48
04/03,"Withdrawal Home Banking Transfer........................................  To HODGES,JUSTINE B 532694 Share 10 REF# 58405865 VILLA",-141.00,707.48
04/03,Recurring Withdrawal Debit Card Visa Check..........................  KING SOOPERS 5053 719-598-5177 CO 5411,-42.64,664.84
04/04,Withdrawal Debit Card Visa Check...........................................  McDonalds 4126 COLORADO SPRI CO 5814,-3.55,661.29
04/04,Withdrawal Debit Card Visa Check...........................................  AMZN Mktp US*HY0HZ7IM2 Amzn.com/bill WA 5942,-31.05,630.24
04/04,Withdrawal POS #309417696362...........................................  KUM&GO 0643R CO SPRINGS COLORADO SPRN CO 5541 Equal Housing Opportunity Ent is a registered trademark of Ent Credit Union Insured by NCUA AccountNumber 1159412 StatementPeriod04/01/23thru04/30/23 Page 3 of 10 1111111111111111111111010011001101110111001110011010100110000001010000001100010011000011101010101010000001111100001100010011000000011000101110000000101111000101010010100101010111000110000100000111010110100011111010011111110011100111001011011100010111011011010000111110111011001111111001001110110000010000010111111000000100000010110010001111010111011111101001001101001110000101101010101101000111111111110011001011000111010011110010001100000110100100001000001010110101010101010101010101 No Strings Checking - 10 NO STRINGS CHECKING (continued) TransDate EffDate TransactionDescription Amount Balance,-16.61,613.63
04/04,Deposit Home Banking Transfer From Share 13......................  REF# 58451489,56.00,669.63
04/04,Withdrawal Home Banking Transfer To Share 13....................  REF# 58451518,-150.00,519.63
04/05,Withdrawal Debit Card Visa Check...........................................  CIRCLE K 09847 COLORADO SPRI CO 5542,-56.56,463.07
04/05,Deposit Home Banking Transfer From Share 00......................  REF# 58457972,200.00,663.07
04/05,Withdrawal POS #309515406336...........................................  CIRCLE K # 40693 COLORADO SPRI CO 5541,-11.71,651.36
04/06,Withdrawal Debit Card Visa Check...........................................  CIRCLE K # 40693 COLORADO SPRI CO 5542,-90.09,561.27
04/06,"Deposit Home Banking Transfer REF# 58489879....................  From HODGES,JUSTINE B 532694 Share 10",789.45,"1,350.72"
04/06,"Withdrawal Home Banking Transfer REF# 58489890..............  To HODGES,JUSTINE B 532694 Share 01",-300.00,"1,050.72"
04/06,Withdrawal Home Banking Transfer To Share 12....................  REF# 58489894,-150.00,900.72
04/06,Withdrawal Home Banking Transfer To Share 13....................  REF# 58489897,-60.00,840.72
04/06,Withdrawal Home Banking Transfer To Share 00....................  REF# 58489900,-75.00,765.72
04/06,Withdrawal Debit Card Visa Check...........................................  DOMINOâ€™S 6259 COLORADO SPRI CO 5814,-29.19,736.53
04/06,Withdrawal Debit Card Visa Check...........................................  AMZN Mktp US*HS5EL53Y2 Amzn.com/bill WA 5942,-368.14,368.39
04/06,Withdrawal POS #309621292435...........................................  CIRCLE K # 40693 COLORADO SPRI CO 5541,-6.48,361.91
04/06,Withdrawal Debit Card Visa Check...........................................  UCCS DINING SERVICES COLORADO SPRI CO 8220,-7.88,354.03
04/06,Withdrawal Debit Card Visa Check...........................................  Equal Housing Opportunity Ent is a registered trademark of Ent Credit Union Insured by NCUA 379361-1.18-61933N11.no8 026847743 2-5 AccountNumber 1159412 StatementPeriod04/01/23thru04/30/23 Page 4 of 10 No Strings Checking - 10 NO STRINGS CHECKING (continued) TransDate EffDate TransactionDescription Amount Balance LEVELUPSMOOTHIEKING78 855-466-5585 MA 5812,-15.67,338.36
04/07,Withdrawal Debit Card Visa Check...........................................  ROADHOUSE CINEMAS - COL 520-661-4749 CO 7832,-30.06,308.30
04/07,Withdrawal POS #309717008966...........................................  COSTCO WHSE #1030 COLORADO SPG CO 5300,-124.89,183.41
04/07,Withdrawal Debit Card Visa Check...........................................  ALBERTACOS MEXICAN FOO COLORADO SPRI CO 5814,-17.10,166.31
04/07,Recurring Withdrawal #309726108602...................................  VASA FITNESS 800-748-4949 UT,-24.99,141.32
04/08,Deposit Home Banking Transfer From Share 12......................  REF# 58563927,140.00,281.32
04/08,Withdrawal POS #309814504519...........................................  KUM&GO 0667R CO SPRIN CO SPRINGS CO 5541,-6.23,275.09
04/08,Withdrawal Debit Card Visa Check...........................................  ROADHOUSE CINEMAS RAILY COLORADO SPRI CO 5812,-24.99,250.10
04/10,Withdrawal Debit Card Visa Check...........................................  094 TORCHYS COLORADO SP COLORADO SPRI CO 5812,-6.39,243.71
04/10,Recurring Withdrawal #310020719231...................................  ADOBE *CREATIVE CLOUD 408-536-6000 CA,-20.60,223.11
04/10,Withdrawal POS #310022539453...........................................  KUM&GO 0667R CO SPRIN CO SPRINGS CO 5541,-10.26,212.85
04/10,Withdrawal Debit Card Visa Check...........................................  LEVELUPSMOOTHIEKING91 855-466-5585 MA 5812,-17.84,195.01
04/11,Withdrawal #310122732298...................................................  8667127753 APPLE COM BILL CUPERTINO CA,-3.99,191.02
04/11,Recurring Withdrawal #310122734797...................................  8667127753 APPLE COM BILL CUPERTINO CA,-0.99,190.03
04/12,Withdrawal Debit Card Visa Check...........................................  STORE*CHICK-FIL-A WWW.DOORDASH. CA 5812,-21.41,168.62
04/12,Withdrawal Debit Card Visa Check...........................................  ALBERTACOS MEXICAN FOO COLORADO SPRI CO 5814,-12.75,155.87
04/13,Withdrawal Debit Card Visa Check...........................................  094 TORCHYS COLORADO SP COLORADO SPRI CO 5812,-6.61,149.26
04/13,Withdrawal Debit Card Visa Check...........................................  094 TORCHYS COLORADO SP COLORADO SPRI CO 5812,-6.46,142.80
04/14,Withdrawal Debit Card Visa Check...........................................  AMZN Mktp US*HJ1BH48K1 Amzn.com/bill WA 5942 Equal Housing Opportunity Ent is a registered trademark of Ent Credit Union Insured by NCUA AccountNumber 1159412 StatementPeriod04/01/23thru04/30/23 Page 5 of 10 1111111111111111111111010011001101110001001110011010100110000001010000001100010011000011101010101010000001100100001100010011000000111000101110000000011111000101010010100110110111000110000100111011010110100011111000011011110011100111010011101100010111011010101111111110111011011000001011011110110001100110011111111000010010110111110010101100001110110111101000011100000001000101101011010000011001111001100110001100110111011011010010111100100110100010001000101011010101010101010101010101 No Strings Checking - 10 NO STRINGS CHECKING (continued) TransDate EffDate TransactionDescription Amount Balance,-32.20,110.60
04/14,Deposit ACH UNIVERSITY OF CO............................................  TYPE: DIR DEP CO: UNIVERSITY OF CO,627.55,738.15
04/14,Withdrawal POS #310418461478...........................................  COSTCO WHSE #1030 COLORADO SPG CO 5300,-90.65,647.50
04/14,Recurring Withdrawal Debit Card Visa Check..........................  APPLE.COM/BILL 866-712-7753 CA 5818,-15.99,631.51
04/14,Withdrawal POS #310421350891...........................................  CIRCLE K 09847 COLORADO SPRN CO 5541,-4.79,626.72
04/15,Withdrawal Debit Card Visa Check...........................................  DP DOUGH COLORADO SPRIN COLORADO SPRI CO 5812,-16.31,610.41
04/15,Withdrawal Debit Card Visa Check...........................................  McDonalds 11078 COLORADO SPRI CO 5814,-3.55,606.86
04/16,Withdrawal Debit Card Visa Check...........................................  094 TORCHYS COLORADO SP COLORADO SPRI CO 5812,-6.52,600.34
04/16,Withdrawal Debit Card Visa Check...........................................  RAISING CANES 0392 COLORADO SPRI CO 5814,-22.70,577.64
04/17,Withdrawal POS #310712221538...........................................  CIRCLE K 09847 COLORADO SPRN CO 5541,-14.45,563.19
04/17,Withdrawal Debit Card Visa Check...........................................  APPLE.COM/BILL 866-712-7753 CA 5818,-2.99,560.20
04/17,Withdrawal Debit Card Visa Check...........................................  094 TORCHYS COLORADO SP COLORADO SPRI CO 5812,-23.94,536.26
04/17,Withdrawal POS #310720485178...........................................  CIRCLE K 09847 COLORADO SPRN CO 5541,-7.39,528.87
04/17,Withdrawal POS #310721177133...........................................  LOWEâ€™S #2578 COLORADO SPGS CO 5200,-6.99,521.88
04/18,Withdrawal Debit Card Visa Check...........................................  TARGET 00022210 COLORADO SPRI CO 5411,-42.74,479.14
04/18,Withdrawal Debit Card Visa Check...........................................  MCDONALDâ€™S F11078 COLORADO SPRI CO 5814,-9.29,469.85
04/18,Withdrawal Debit Card Visa Check...........................................  PANDA EXPRESS #687 COLORADO SPRI CO 5814,-19.15,450.70
04/18,Withdrawal Debit Card Visa Check...........................................  Equal Housing Opportunity Ent is a registered trademark of Ent Credit Union Insured by NCUA 379361-1.18-61933N11.no8 026847743 3-5 AccountNumber 1159412 StatementPeriod04/01/23thru04/30/23 Page 6 of 10 No Strings Checking - 10 NO STRINGS CHECKING (continued) TransDate EffDate TransactionDescription Amount Balance LOWES #00907* 866-483-7521 NC 5200,-7.55,443.15
04/18,Withdrawal Debit Card Visa Check...........................................  CHICK-FIL-A #02342 COLO SPGS CO 5814,-9.94,433.21
04/18,Withdrawal Debit Card Visa Check...........................................  PP*DUTCHBROSLL GRANTS PASS OR 5814,-6.16,427.05
04/19,Withdrawal Debit Card Visa Check...........................................  CIRCLE K 09847 COLORADO SPRI CO 5542,-54.48,372.57
04/19,Deposit ACH SUCCESS FOODS MA.........................................  TYPE: PAYROLL CO: SUCCESS FOODS MA,294.43,667.00
04/19,Withdrawal POS #310908142535...........................................  CIRCLE K 09847 COLORADO SPRN CO 5541,-2.30,664.70
04/19,Withdrawal Home Banking Transfer To Share 11....................  REF# 58864187,-300.00,364.70
04/19,Recurring Withdrawal Debit Card Visa Check..........................  APPLE.COM/BILL 866-712-7753 CA 5818,-0.99,363.71
04/19,Withdrawal Debit Card Visa Check...........................................  LOWES #00907* 866-483-7521 NC 5200,-14.29,349.42
04/19,Withdrawal POS #310918339070...........................................  CIRCLE K 09847 COLORADO SPRN CO 5541,-22.80,326.62
04/20,Withdrawal Debit Card Visa Check...........................................  IBI*FABLETICS.COM 855-2023570 CA 5968,-16.92,309.70
04/20,Withdrawal Debit Card Visa Check...........................................  RAISING CANES 0468 COLORADO SPRI TX 5814,-22.70,287.00
04/20,Withdrawal POS #311018519384...........................................  KUM&GO 0665R CO SPRIN CO SPRINGS CO 5541,-3.05,283.95
04/20,Withdrawal POS #311020267037...........................................  CIRCLE K 09847 COLORADO SPRN CO 5541,-7.99,275.96
04/21,Withdrawal Debit Card Visa Check...........................................  McDonalds 11078 COLORADO SPRI CO 5814,-6.04,269.92
04/21,Withdrawal Debit Card Visa Check...........................................  094 TORCHYS COLORADO SP COLORADO SPRI CO 5812,-6.61,263.31
04/21,"Deposit Home Banking Transfer REF# 58958361....................  From HODGES,JUSTINE B 532694 Share 10",130.00,393.31
04/21,Withdrawal Debit Card Visa Check...........................................  Equal Housing Opportunity Ent is a registered trademark of Ent Credit Union Insured by NCUA AccountNumber 1159412 StatementPeriod04/01/23thru04/30/23 Page 7 of 10 1111111111111111111111010011001101110011001110011010100110010001010000001100010011000011101010101010000001001100001100010011000001011000101110000000000001000101010010100100110111000110000100101101010110100011111000011111110011100111111011001101010111011001101100111010111011011011110101001110110000010010010111111000100010000111010011011101110001010111101100111011101111100100010011000110000010111001101011101110111111010010110000010100010110100000001001001011010101010101010101010101 No Strings Checking - 10 NO STRINGS CHECKING (continued) TransDate EffDate TransactionDescription Amount Balance LEVELUPSMOOTHIEKING64 855-466-5585 MA 5812,-15.13,378.18
04/22,Withdrawal Debit Card Visa Check...........................................  2574PEPSIVEN9147678600 COLORADO SPRI CO 5814,-2.25,375.93
04/22,Withdrawal POS #311212637740...........................................  SAFEWAY #4615 FALCON CO 5411,-4.48,371.45
04/22,Withdrawal Debit Card Visa Check...........................................  LOWES #00907* 866-483-7521 NC 5200,-186.60,184.85
04/23,Withdrawal POS #311310101087...........................................  LOWEâ€™S #2423 COLORADOSPRIN CO 5200,-27.92,156.93
04/23,Withdrawal POS #311311077917...........................................  MAVERIK #608 COLORADO SPRI CO 5541,-7.88,149.05
04/23,Withdrawal POS #311313679135...........................................  KUM&GO 0665R CO SPRIN CO SPRINGS CO 5541,-7.39,141.66
04/23,Withdrawal Debit Card Visa Check...........................................  094 TORCHYS COLORADO SP COLORADO SPRI CO 5812,-5.62,136.04
04/23,Withdrawal Debit Card Visa Check...........................................  SONIC #4735 PEYTON CO 5814,-11.66,124.38
04/24,Withdrawal Debit Card Visa Check...........................................  094 TORCHYS COLORADO SP COLORADO SPRI CO 5812,-7.40,116.98
04/24,Withdrawal Debit Card Visa Check...........................................  094 TORCHYS COLORADO SP COLORADO SPRI CO 5812,-6.55,110.43
04/25,Withdrawal Debit Card Visa Check...........................................  PANDA EXPRESS 700 COLORADO SPRI CO 5814,-12.98,97.45
04/25,Withdrawal Debit Card Visa Check...........................................  094 TORCHYS COLORADO SP COLORADO SPRI CO 5812,-3.56,93.89
04/25,Withdrawal Debit Card Visa Check...........................................  RAISING CANES 0468 COLORADO SPRI TX 5814,-10.81,83.08
04/26,Withdrawal Debit Card Visa Check...........................................  CIRCLE K 09874 COLORADO SPRI CO 5499,-5.96,77.12
04/26,Withdrawal POS #311617341562...........................................  TRADER JOE S #30 TRADER COLORADO SPRI CO 5411,-3.79,73.33
04/26,Withdrawal Debit Card Visa Check...........................................  Equal Housing Opportunity Ent is a registered trademark of Ent Credit Union Insured by NCUA 379361-1.18-61933N11.no8 026847743 4-5 AccountNumber 1159412 StatementPeriod04/01/23thru04/30/23 Page 8 of 10 No Strings Checking - 10 NO STRINGS CHECKING (continued) TransDate EffDate TransactionDescription Amount Balance ALBERTACOS MEXICAN FOO COLORADO SPRI CO 5814,-18.10,55.23
04/26,Withdrawal Debit Card Visa Check...........................................  Subway 24261 Colorado Spri CO 5814,-25.55,29.68
04/26,Withdrawal Debit Card Visa Check...........................................  LEVELUPSMOOTHIEKING26 855-466-5585 MA 5812,-17.84,11.84
04/27,Withdrawal POS #311709310084...........................................  CIRCLE K 09847 COLORADO SPRN CO 5541,-7.63,4.21
04/27,Deposit Home Banking Transfer From Share 12......................  REF# 59088361,160.00,164.21
04/27,Withdrawal POS #311718079487...........................................  EMPIRE 8154 COLORADO SPRI CO 5541,-23.86,140.35
04/28,Withdrawal Debit Card Visa Check...........................................  CIRCLE K 09847 COLORADO SPRI CO 5542,-57.00,83.35
04/28,Deposit ACH UNIVERSITY OF CO............................................  TYPE: DIR DEP CO: UNIVERSITY OF CO DEP PRENOTIFICATION FROM UNIVERSITY OF CO,590.62,673.97
04/28,Withdrawal Debit Card Visa Check...........................................  RED ROBIN NO 207 COLORADO SPRI CO 5812,-56.34,617.63
04/28,Withdrawal POS #311814001015...........................................  MAVERIK #608 COLORADO SPRI CO 5542,-20.04,597.59
04/28,Withdrawal Debit Card Visa Check...........................................  RAISING CANES 0468 COLORADO SPRI TX 5814,-10.61,586.98
04/28,Withdrawal Debit Card Visa Check...........................................  094 TORCHYS COLORADO SP COLORADO SPRI CO 5812,-6.79,580.19
04/28,Withdrawal POS #311800016990...........................................  KING SOOPERS #0119 9225 N. UNION COLORADO SPRI CO 5411,-54.92,525.27
04/28,Withdrawal Debit Card Visa Check...........................................  LEVELUPSMOOTHIEKING01 855-466-5585 MA 5812,-15.13,510.14
04/29,Withdrawal POS #311900605798...........................................  SEI 33710 6040 BARNES RD US COLORADO SPRI CO 5541,-9.30,500.84
04/29,Withdrawal POS #311912403090...........................................  COSTCO WHSE #1014 COLORADO SPRI CO 5300,-180.40,320.44
04/30,Withdrawal Debit Card Visa Check...........................................  094 TORCHYS COLORADO SP COLORADO SPRI CO 5812,-6.61,313.83
04/30,Withdrawal POS #312020541666...........................................  KING SOOPERS #01 9225 N COLORADO SPRI CO Equal Housing Opportunity Ent is a registered trademark of Ent Credit Union Insured by NCUA AccountNumber 1159412 StatementPeriod04/01/23thru04/30/23 Page 9 of 10 1111111111111111111111010001001101110101001110011010100110000001010000001100010011000011101010101010000001010100001100010011000011011000101110000000110011000101010010100100010111000110000100011101010110100011111000001011110011100111001001111101010111011000110110111010111011000000010001011110110001111110101111111000111011000010110011111101110001111111101010100011001001100100111101101111111101111001111111111010101111010100010011010100000110100110111000101011110101010101010101010101 No Strings Checking - 10 NO STRINGS CHECKING (continued) TransDate EffDate TransactionDescription Amount Balance 5411,-61.69,252.14
04/30,"Deposit Dividend Tiered Rate..................................................  Annual Percentage Yield Earned 0.030% for period: 04/01/23 to 04/30/23 Ending Balance............................................................................. 252.15 No Strings Checking - 11 NO STRINGS CHECKING Dividends Earned YTD: 0.05 JointOwner:TYMITCHELL Beginning Balance + Deposits & Other Credits (4) - Checks Cleared (0) - Withdrawals & Other Debits (0) = Ending Balance $0.01 $1,200.04 $0.00 $0.00 $1,200.05 TransDate EffDate TransactionDescription Amount Balance Beginning Balance......................................................................... 0.01",0.01,252.15
04/04,"Deposit Home Banking Transfer REF# 58451730....................  From HODGES,JUSTINE B 532694 Share 10",600.00,600.01
04/06,"Deposit Home Banking Transfer REF# 58499861....................  From HODGES,JUSTINE B 532694 Share 01",300.00,900.01
04/19,Deposit Home Banking Transfer From Share 10......................  REF# 58864187,300.00,"1,200.01"
04/30,"Deposit Dividend Tiered Rate..................................................  Annual Percentage Yield Earned 0.050% for period: 04/01/23 to 04/30/23 Ending Balance............................................................................. 1,200.05 No Strings Checking - 12 NO STRINGS CHECKING Dividends Earned YTD: 0.01 JointOwner:TYMITCHELL Beginning Balance + Deposits & Other Credits (2) - Checks Cleared (0) - Withdrawals & Other Debits (2) = Ending Balance $150.00 $150.01 $0.00 $300.00 $0.01 TransDate EffDate TransactionDescription Amount Balance Beginning Balance......................................................................... 150.00",0.04,"1,200.05"
04/06,Deposit Home Banking Transfer From Share 10......................  REF# 58489894,150.00,300.00
04/08,Withdrawal Home Banking Transfer To Share 10....................  REF# 58563927,-140.00,160.00
04/27,Withdrawal Home Banking Transfer To Share 10....................  REF# 59088361,-160.00,0.00
04/30,Deposit Dividend Tiered Rate..................................................  Annual Percentage Yield Earned 0.080% for period: 04/01/23 to 04/30/23 Ending Balance............................................................................. 0.01 Equal Housing Opportunity Ent is a registered trademark of Ent Credit Union Insured by NCUA 379361-1.18-61933N11.no8 026847743 5-5 AccountNumber 1159412 StatementPeriod04/01/23thru04/30/23 Page 10 of 10 No Strings Checking - 13 NO STRINGS CHECKING Dividends Earned YTD: 0.01 JointOwner:TYMITCHELL Beginning Balance + Deposits & Other Credits (3) - Checks Cleared (0) - Withdrawals & Other Debits (3) = Ending Balance $120.00 $210.01 $0.00 $236.00 $94.01 TransDate EffDate TransactionDescription Amount Balance Beginning Balance......................................................................... 120.00,0.01,0.01
04/04,Withdrawal Home Banking Transfer To Share 10....................  REF# 58451489,-56.00,64.00
04/04,Deposit Home Banking Transfer From Share 10......................  REF# 58451518,150.00,214.00
04/06,Deposit Home Banking Transfer From Share 10......................  REF# 58489897,60.00,274.00
04/12,"Withdrawal Home Banking Transfer REF# 58656095..............  To HODGES,JUSTINE B 532694 Share 10",-40.00,234.00
04/24,"Withdrawal Home Banking Transfer........................................  To HODGES,JUSTINE B 532694 Share 10 REF# 59012041 VILLA",-140.00,94.00
04/30,"Deposit Dividend Tiered Rate..................................................  Annual Percentage Yield Earned 0.060% for period: 04/01/23 to 04/30/23 Ending Balance............................................................................. 94.01 YEAR-TO-DATE DIVIDEND SUMMARY Reportable Dividends this Year:............................................................................. 0.16 Reportable dividends of $10.00 or more are reported to the IRS as interest income for the year. ** The Visa Foreign Currency Transaction Fee will be assessed to purchases made outside of the United States as well as to online purchases made within the United States, but the merchant is located outside the United States. ** No-cost loan payment alternatives are available, please call 800-525-9623 for more information. Equal Housing Opportunity Ent is a registered trademark of Ent Credit Union Insured by NCUA",0.01,94.01
07/01,"Withdrawal Home Banking Transfer REF# 61038140..............  To HODGES,JUSTINE B 532694 Share 01",-170.00,"1,586.15"
07/03,"Withdrawal Home Banking Transfer REF# 61097741..............  To HODGES,JUSTINE B 532694 Share 10",-25.00,"1,561.15"
07/07,Deposit ACH UNIVERSITY OF CO............................................  TYPE: DIR DEP CO: UNIVERSITY OF CO,221.12,"1,782.27"
07/08,Withdrawal Home Banking Transfer To Share 10....................  REF# 61268088,-175.00,"1,607.27"
07/14,Deposit Home Banking Transfer From Share 10......................  REF# 61413949,75.00,"1,682.27"
07/21,Deposit ACH UNIVERSITY OF CO............................................  TYPE: DIR DEP CO: UNIVERSITY OF CO,178.92,"1,861.19"
07/22,"Withdrawal Home Banking Transfer REF# 61661367..............  To HODGES,JUSTINE B 532694 Share 00","-1,800.00",61.19
07/23,Withdrawal Home Banking Transfer To Share 10....................  Equal Housing Opportunity Ent is a registered trademark of Ent Credit Union Insured by NCUA AccountNumber 1159412 StatementPeriod07/01/23thru07/31/23 Page 2 of 11 Primary Savings - 00 PRIMARY SAVINGS (continued) TransDate EffDate TransactionDescription Amount Balance REF# 61688352,-30.00,31.19
07/24,Withdrawal Home Banking Transfer To Share 10....................  REF# 61703927,-25.00,6.19
07/31,"Deposit Dividend 0.050%........................................................  Annual Percentage Yield Earned 0.050% for period: 07/01/23 to 07/31/23 Ending Balance............................................................................. 6.24 No Strings Checking - 10 NO STRINGS CHECKING Dividends Earned YTD: 0.04 JointOwner:TYMITCHELL Beginning Balance + Deposits & Other Credits (21) - Checks Cleared (0) - Withdrawals & Other Debits (101)= Ending Balance $594.34 $6,309.23 $0.00 $6,753.15 $150.42 TransDate EffDate TransactionDescription Amount Balance Beginning Balance......................................................................... 594.34",0.05,6.24
07/01,Withdrawal POS #318218821934...........................................  COSTCO WHSE #1014 COLORADO SPRI CO 5300,-171.87,422.47
07/02,Withdrawal Debit Card Visa Check...........................................  TARGET 00022210 COLORADO SPRI CO 5411,-11.29,411.18
07/02,Recurring Withdrawal #318325103508...................................  Audible*KT1IM39F3 Amzn.com/bill NJ,-16.18,395.00
07/02,Withdrawal POS #318401362524...........................................  KING SOOPERS #01 9225 N COLORADO SPRI CO 5411,-60.86,334.14
07/03,Withdrawal Debit Card Visa Check...........................................  AMZN Mktp US*VG6HS94Z3 Amzn.com/bill WA 5942,-142.01,192.13
07/03,"Withdrawal Home Banking Transfer........................................  To HODGES,JUSTINE B 532694 Share 10 REF# 61100149 1/2 SOFTBALL",-60.00,132.13
07/03,Deposit Debit Card...................................................................  VENMO*Hodges Justine New York City NY Date 07/03/23 4829,63.87,196.00
07/04,Recurring Withdrawal Debit Card Visa Check..........................  APPLE.COM/BILL 866-712-7753 CA 5818,-0.99,195.01
07/04,Withdrawal Debit Card Visa Check...........................................  DUTCH BROS 541-955-4700 OR 5814,-15.00,180.01
07/05,Withdrawal POS #318609812490...........................................  KUM&GO 0659R CO SPRIN CO SPRINGS CO 5541,-7.46,172.55
07/05,Withdrawal Debit Card Visa Check...........................................  Equal Housing Opportunity Ent is a registered trademark of Ent Credit Union Insured by NCUA AccountNumber 1159412 StatementPeriod07/01/23thru07/31/23 Page 3 of 11 1111111111111111111111010011001100110111001110011000100010000001010000001110100011000011101011000110000001011100001100010011000011011000100110000000101011000100110010100111010111001010000100101111010100010011111011111011101011000111001111111101110011011010011100111010110011110010110011000010110001011111011111011000000111100101010001001100000010100101111110001100101000111100110000110000001101111110010110011111000111011011110011001100010111110010001000101010110101010101010101010101 No Strings Checking - 10 NO STRINGS CHECKING (continued) TransDate EffDate TransactionDescription Amount Balance STEAMGAMES.COM 42595229 425-8899642 WA 5816,-9.26,163.29
07/06,"Withdrawal Home Banking Transfer REF# 61198600..............  To HODGES,JUSTINE B 532694 Share 10",-60.00,103.29
07/07,Recurring Withdrawal Debit Card Visa Check..........................  COOKBOOK MOUNT COOLUM AU 5817,-1.49,101.80
07/07,Recurring Withdrawal Card Fee...............................................  VISA INTERNATIONAL SERVICE ASSESSMENT Date 07/07/23,-0.01,101.79
07/07,Deposit ACH UNIVERSITY OF CO............................................  TYPE: DIR DEP CO: UNIVERSITY OF CO,884.46,986.25
07/07,Withdrawal Debit Card Visa Check...........................................  DOMINOâ€™S 6246 COLORADO SPRI CO 5814,-28.91,957.34
07/07,Withdrawal Debit Card Visa Check...........................................  KUM&GO 0659R CO SPRIN CO SPRINGS CO 5542,-20.23,937.11
07/07,Withdrawal Debit Card Visa Check...........................................  VENMO* Visa Direct NY 4829,-15.00,922.11
07/07,Withdrawal Debit Card Visa Check...........................................  Amazon.com*KL5DY2UF3 Amzn.com/bill WA 5942,-14.34,907.77
07/07,Withdrawal Debit Card Visa Check...........................................  AMZN Mktp US*PM2AD45D3 Amzn.com/bill WA 5942,-41.33,866.44
07/08,Withdrawal Debit Card Visa Check...........................................  Amazon.com*E61OY2YA3 Amzn.com/bill WA 5942,-7.89,858.55
07/08,Withdrawal Home Banking Transfer To Share 11....................  REF# 61253231,-300.00,558.55
07/08,"Withdrawal Home Banking Transfer REF# 61253232..............  To HODGES,JUSTINE B 532694 Share 01",-100.00,458.55
07/08,"Withdrawal Home Banking Transfer REF# 61253233..............  To HODGES,JUSTINE B 532694 Share 10",-35.00,423.55
07/08,"Withdrawal Home Banking Transfer REF# 61253234..............  To HODGES,JUSTINE B 532694 Share 12 Equal Housing Opportunity Ent is a registered trademark of Ent Credit Union Insured by NCUA 391340-1.38-26008N11.no7 028700194 2-6 AccountNumber 1159412 StatementPeriod07/01/23thru07/31/23 Page 4 of 11 No Strings Checking - 10 NO STRINGS CHECKING (continued) TransDate EffDate TransactionDescription Amount Balance",-75.00,348.55
07/08,Withdrawal POS #318914056307...........................................  COSTCO WHSE #1014 COLORADO SPRI CO 5300,-166.96,181.59
07/08,Withdrawal Debit Card Visa Check...........................................  SQ *WORLD GOLF & SAND C Colorado Spri CO 5399,-12.00,169.59
07/08,Deposit Home Banking Transfer From Share 00......................  REF# 61268088,175.00,344.59
07/08,Withdrawal Debit Card Visa Check...........................................  VENMO* Visa Direct NY 4829,-16.00,328.59
07/09,Withdrawal Debit Card Visa Check...........................................  Amazon.com*BC5208OI3 Amzn.com/bill WA 5942,-139.82,188.77
07/09,Withdrawal POS #319018951826...........................................  KING SOOPERS #01 9225 N COLORADO SPRI CO 5411,-44.33,144.44
07/09,Withdrawal Debit Card Visa Check...........................................  ULTA #133 COLORADO SPRI CO 5977,-47.59,96.85
07/09,Withdrawal Debit Card Visa Check...........................................  RAISING CANES 0403 COLORADO SPRI CO 5814,-21.24,75.61
07/10,Recurring Withdrawal #319120743317...................................  ADOBE *CREATIVE CLOUD 408-536-6000 CA,-20.60,55.01
07/11,Withdrawal POS #319300810938...........................................  SEI 26292 825 NORTH NEVADA US COLORADO SPRI CO 5541,-5.92,49.09
07/11,Deposit Home Banking Transfer From Share 13......................  REF# 61344996,70.00,119.09
07/12,"07/11 Deposit Home Banking Transfer..............................................  From HODGES,JUSTINE B 532694 Loan 01 REF# 61350107 TV-PRIME DAY",640.00,759.09
07/12,Withdrawal Debit Card Visa Check...........................................  KUM&GO 0659R CO SPRIN CO SPRINGS CO 5542,-71.17,687.92
07/12,Withdrawal POS #319322134725...........................................  CIRCLE K 09847 COLORADO SPRN CO 5541,-4.77,683.15
07/13,Withdrawal POS #319408583001...........................................  KUM&GO 0659R CO SPRIN CO SPRINGS CO 5541,-7.46,675.69
07/13,Withdrawal Debit Card Visa Check...........................................  KUM&GO 0667R CO SPRIN CO SPRINGS CO 5542,-40.01,635.68
07/13,Withdrawal Debit Card Visa Check...........................................  Amazon.com*P86667JH3 Amzn.com/bill WA 5942,-32.73,602.95
07/13,Deposit Home Banking Transfer From Share 13......................  Equal Housing Opportunity Ent is a registered trademark of Ent Credit Union Insured by NCUA AccountNumber 1159412 StatementPeriod07/01/23thru07/31/23 Page 5 of 11 1111111111111111111111010011001100110001001110011000100010000001010000001110100011000011101011000110000001000100001100010011000011111000100110000000011011000100110010100100110111001010000100010011010100010011111001111111101011000111010111001101110011011011100011111010110011100101000001010010110000101001010111011000010001010000010001101111011011001101111111011101100111111100110001001101010011111000000011011000110111010011010011111100110111110100001000001011010101010101010101010101 No Strings Checking - 10 NO STRINGS CHECKING (continued) TransDate EffDate TransactionDescription Amount Balance REF# 61398823,40.00,642.95
07/14,Deposit ACH Colorado Springs................................................  TYPE: PR PAYMENT CO: Colorado Springs,"1,273.20","1,916.15"
07/14,Withdrawal Home Banking Transfer To Share 11....................  REF# 61413719,-300.00,"1,616.15"
07/14,Withdrawal Home Banking Transfer To Share 13....................  REF# 61413800,-140.00,"1,476.15"
07/14,"Withdrawal Home Banking Transfer REF# 61413828..............  To HODGES,JUSTINE B 532694 Share 11",-35.00,"1,441.15"
07/14,"Withdrawal Home Banking Transfer REF# 61413845..............  To HODGES,JUSTINE B 532694 Share 12",-125.00,"1,316.15"
07/14,"Withdrawal Home Banking Transfer REF# 61413857..............  To HODGES,JUSTINE B 532694 Share 01",-150.00,"1,166.15"
07/14,Withdrawal Home Banking Transfer To Share 00....................  REF# 61413949,-75.00,"1,091.15"
07/14,Withdrawal Debit Card Visa Check...........................................  VENMO* Visa Direct NY 4829,-8.00,"1,083.15"
07/14,"Deposit Home Banking Transfer REF# 61445217....................  From HODGES,JUSTINE B 532694 Share 10",500.00,"1,583.15"
07/14,Recurring Withdrawal Debit Card Visa Check..........................  APPLE.COM/BILL 866-712-7753 CA 5818,-15.99,"1,567.16"
07/14,Recurring Withdrawal Debit Card Visa Check..........................  APPLE.COM/BILL 866-712-7753 CA 5818,-0.99,"1,566.17"
07/14,Withdrawal POS #319523421450...........................................  DICKâ€™S SPORTING #322 COLORADO SPRI CO 5941,-81.12,"1,485.05"
07/15,Withdrawal Debit Card Visa Check...........................................  ZALES #1327 COLORADO SPRI CO 5944,-461.22,"1,023.83"
07/15,Withdrawal POS #319612401966...........................................  PETCO 1472 COLORADO SPRI CO 5995,-21.15,"1,002.68"
07/15,Withdrawal Debit Card Visa Check...........................................  Equal Housing Opportunity Ent is a registered trademark of Ent Credit Union Insured by NCUA 391340-1.38-26008N11.no7 028700194 3-6 AccountNumber 1159412 StatementPeriod07/01/23thru07/31/23 Page 6 of 11 No Strings Checking - 10 NO STRINGS CHECKING (continued) TransDate EffDate TransactionDescription Amount Balance IN N OUT BURGER 359 COLORADO SPRI CO 5814,-17.43,985.25
07/15,Withdrawal POS #319700737370...........................................  UNITED PACIFIC 6 10210 E ARAPAHOE R US CENTENNIAL CO 5541,-8.17,977.08
07/15,Withdrawal Debit Card Visa Check...........................................  TARGET 00022210 COLORADO SPRI CO 5411,-7.57,969.51
07/15,Withdrawal Debit Card Visa Check...........................................  VENMO* Visa Direct NY 4829,-10.00,959.51
07/16,Withdrawal Debit Card Visa Check...........................................  BUFF CITY SOAP - DUBLIN COLORADO SPRI CO 5099,-28.39,931.12
07/16,Withdrawal Debit Card Visa Check...........................................  RAISING CANES 0276 CASTLE ROCK CO 5814,-18.65,912.47
07/17,Withdrawal POS #319817883562...........................................  COSTCO WHSE #1014 COLORADO SPRI CO 5300,-58.64,853.83
07/17,Deposit Home Banking Transfer From Share 13......................  REF# 61523416,70.00,923.83
07/17,Withdrawal POS #319818782546...........................................  LOVELAND COUNTRY LOVELAND CO 5541,-9.58,914.25
07/17,Withdrawal POS #319900308695...........................................  KING SOOPERS #01 9225 N COLORADO SPRI CO 5411,-64.80,849.45
07/17,Withdrawal Debit Card Visa Check...........................................  PP*Emalie Atteberry LOVELAND CO 7230,-60.00,789.45
07/18,Withdrawal POS #319920854403...........................................  KUM&GO 0693R CO SPRINGS COLORADO SPRN CO 5541,-15.18,774.27
07/18,Withdrawal Debit Card Visa Check...........................................  Amazon.com*HX0KT2VO3 Amzn.com/bill WA 5942,-605.91,168.36
07/18,Withdrawal Debit Card Visa Check...........................................  DP DOUGH COLORADO SPRIN 678-787-9643 CO 5812,-4.43,163.93
07/20,"Deposit Home Banking Transfer REF# 61596534....................  From MITCHELL,JILLIAN 918043 Share 10 AMZN Mktp US Pending credit/return for $43.27 on card 0950",150.00,313.93
07/21,Withdrawal Adjustment Debit Card Credit Voucher.................  AMZN Mktp US Amzn.com/bill WA 5942,43.27,357.20
07/21,Deposit ACH UNIVERSITY OF CO............................................  Equal Housing Opportunity Ent is a registered trademark of Ent Credit Union Insured by NCUA AccountNumber 1159412 StatementPeriod07/01/23thru07/31/23 Page 7 of 11 1111111111111111111111010011001100110011001110011000100010010001010000001110100011000011101011000110000001110100001100010011000001011000100110000000101111000100110010100101010111001010000100001011010100010011111010100111101011000111110001111101110011011001000010111110110011100111110001000010110011011101110111011000101100001000010001001101000100110101111100101001010001011100111100010001111001111000000100101111001011011111010001100100100111110110001000101011010101010101010101010101 No Strings Checking - 10 NO STRINGS CHECKING (continued) TransDate EffDate TransactionDescription Amount Balance TYPE: DIR DEP CO: UNIVERSITY OF CO,715.67,"1,072.87"
07/21,Withdrawal POS #320200117131...........................................  KING SOOPERS #719 FUEL 9255 N UNION BL COLORADO SPRI CO 5542,-45.00,"1,027.87"
07/22,Withdrawal Debit Card Visa Check...........................................  SONIC DRIVE IN #5256 COLORADO SPRI CO 5814,-20.20,"1,007.67"
07/22,Withdrawal POS #320309559835...........................................  KUM&GO 0659R CO SPRIN CO SPRINGS CO 5541,-12.99,994.68
07/22,Withdrawal Home Banking Transfer To Share 11....................  REF# 61659217,-300.00,694.68
07/22,Withdrawal Home Banking Transfer To Share 13....................  REF# 61659225,-40.00,654.68
07/22,"Withdrawal Home Banking Transfer REF# 61659233..............  To HODGES,JUSTINE B 532694 Share 11",-35.00,619.68
07/22,"Withdrawal Home Banking Transfer REF# 61659278..............  To HODGES,JUSTINE B 532694 Share 01",-100.00,519.68
07/22,"Withdrawal Home Banking Transfer REF# 61659289..............  To HODGES,JUSTINE B 532694 Share 12",-100.00,419.68
07/22,Deposit Home Banking Transfer From Share 13......................  REF# 61666955,70.00,489.68
07/22,Withdrawal POS #320317649475...........................................  COSTCO WHSE #1014 COLORADO SPRI CO 5300,-2.15,487.53
07/22,Withdrawal POS #320317649940...........................................  COSTCO WHSE #1014 COLORADO SPRI CO 5300,-86.78,400.75
07/22,Withdrawal POS #320300015795...........................................  KING SOOPERS #0119 9225 N. UNION COLORADO SPRI CO 5411,-28.90,371.85
07/23,Deposit Home Banking Transfer From Share 13......................  REF# 61678441,70.00,441.85
07/23,Withdrawal Debit Card Visa Check...........................................  BOOTBARN.COM 888-440-2668 CA 5661,-309.66,132.19
07/23,Deposit Home Banking Transfer From Share 00......................  REF# 61688352,30.00,162.19
07/24,Withdrawal Debit Card Visa Check...........................................  Equal Housing Opportunity Ent is a registered trademark of Ent Credit Union Insured by NCUA 391340-1.38-26008N11.no7 028700194 4-6 AccountNumber 1159412 StatementPeriod07/01/23thru07/31/23 Page 8 of 11 No Strings Checking - 10 NO STRINGS CHECKING (continued) TransDate EffDate TransactionDescription Amount Balance AMZN Mktp US*2Q1TW26Q3 Amzn.com/bill WA 5942,-62.99,99.20
07/24,Withdrawal Debit Card Visa Check...........................................  MAVERIK #608 COLORADO SPRI CO 5541,-11.63,87.57
07/24,Withdrawal Debit Card Visa Check...........................................  MAVERIK #608 COLORADO SPRI CO 5542,-64.65,22.92
07/24,Withdrawal Debit Card Visa Check...........................................  PANDA EXPRESS #3558 FALCON CO 5814,-11.67,11.25
07/24,Deposit Home Banking Transfer From Share 00......................  REF# 61703927,25.00,36.25
07/24,Deposit Debit Card...................................................................  VENMO*Hodges Justine New York City NY Date 07/24/23 4829,10.25,46.50
07/24,Withdrawal Debit Card Visa Check...........................................  WL *Steam Purchase 425-9522985 WA 5816,-15.45,31.05
07/24,Withdrawal Debit Card Visa Check...........................................  WL *Steam Purchase 425-9522985 WA 5816,-15.45,15.60
07/25,Deposit Home Banking Transfer From Share 11......................  REF# 61745319,25.00,40.60
07/25,Withdrawal POS #320619764023...........................................  KUM&GO 0693R CO SPRINGS COLORADO SPRN CO 5541,-27.37,13.23
07/26,Withdrawal Debit Card Visa Check...........................................  MCDONALDâ€™S F26480 COLORADO SPRI CO 5814,-3.33,9.90
07/28,Deposit ACH Colorado Springs................................................  TYPE: PR PAYMENT CO: Colorado Springs,"1,253.49","1,263.39"
07/28,Withdrawal POS #320915852938...........................................  Boot Barn #85 Colorado Spri CO 5661,-18.38,"1,245.01"
07/28,Withdrawal Home Banking Transfer To Share 11....................  REF# 61834567,-300.00,945.01
07/28,Withdrawal POS #320900016991...........................................  KING SOOPERS #0119 9225 N. UNION COLORADO SPRI CO 5411,-44.22,900.79
07/28,Withdrawal Debit Card Visa Check...........................................  DP DOUGH COLORADO SPRIN 678-787-9643 CO 5812,-4.44,896.35
07/29,Withdrawal Debit Card Visa Check...........................................  THE UPS STORE 7267 719-3312719 CO 7399 Equal Housing Opportunity Ent is a registered trademark of Ent Credit Union Insured by NCUA AccountNumber 1159412 StatementPeriod07/01/23thru07/31/23 Page 9 of 11 1111111111111111111111010011001100110101001110011000100010000001010000001110100011000011101011000110000001101100001100010011000011111000100110000000110111000100110010100101010111001010000100101011010100010011111001000011101011000111101100001101110011011010101110111110110011011010000111010010110011110001111111011000100100000000110000001111111010011101111111000101110100011101000111110110011101111011001110101010010111010110010010100100010111110100001000001011110101010101010101010101 No Strings Checking - 10 NO STRINGS CHECKING (continued) TransDate EffDate TransactionDescription Amount Balance,-0.97,895.38
07/29,Withdrawal at ATM #000000008426.......................................  ENT CREDIT UNION 7339 DURYEA DRIVE COLORADO SPRI CO,-50.00,845.38
07/29,Withdrawal POS #321009774744...........................................  KUM&GO 0667R CO SPRIN CO SPRINGS CO 5541,-9.27,836.11
07/29,Withdrawal Debit Card Visa Check...........................................  AMZN Mktp US*TH2RI2JG2 Amzn.com/bill WA 5942,-0.28,835.83
07/29,Withdrawal Debit Card Visa Check...........................................  BOOTBARN.COM 888-440-2668 CA 5661,-281.31,554.52
07/29,Withdrawal POS #321016054584...........................................  EMPIRE 8155 COLORADO SPGS CO 5542,-72.19,482.33
07/29,Withdrawal POS #321022359840...........................................  Tan Your Hide #11 Colorado spri CO 7230,-44.95,437.38
07/30,Withdrawal POS #321113857428...........................................  MAVERIK #608 COLORADO SPRI CO 5542,-40.08,397.30
07/30,Deposit Home Banking Transfer From Share 11......................  REF# 61883097,200.00,597.30
07/30,Withdrawal POS #321116616214...........................................  COSTCO WHSE #1014 COLORADO SPRI CO 5300,-186.52,410.78
07/30,Withdrawal POS #321120358893...........................................  KING SOOPERS #01 9225 N COLORADO SPRI CO 5411,-6.98,403.80
07/30,Withdrawal Debit Card Visa Check...........................................  CALHAN SCHOOL DISTRICT CALHAN CO 8211,-10.00,393.80
07/31,Withdrawal Debit Card Visa Check...........................................  MAVERIK #608 COLORADO SPRI CO 5541 BOOTBARN.COM Pending credit/return for $309.66 on card 0950,-8.40,385.40
07/31,"Withdrawal Home Banking Transfer REF# 61926184..............  To HODGES,JUSTINE B 532694 Share 01",-100.00,285.40
07/31,"Withdrawal Home Banking Transfer REF# 61926199..............  To HODGES,JUSTINE B 532694 Share 12",-100.00,185.40
07/31,"Withdrawal Home Banking Transfer REF# 61926212..............  To HODGES,JUSTINE B 532694 Share 11",-35.00,150.40
07/31,"Deposit Dividend Tiered Rate..................................................  Annual Percentage Yield Earned 0.060% for period: 07/01/23 to 07/31/23 Ending Balance............................................................................. 150.42 Equal Housing Opportunity Ent is a registered trademark of Ent Credit Union Insured by NCUA 391340-1.38-26008N11.no7 028700194 5-6 AccountNumber 1159412 StatementPeriod07/01/23thru07/31/23 Page 10 of 11 No Strings Checking - 11 NO STRINGS CHECKING Dividends Earned YTD: 0.14 JointOwner:TYMITCHELL Beginning Balance + Deposits & Other Credits (6) - Checks Cleared (0) - Withdrawals & Other Debits (3) = Ending Balance $300.11 $1,225.03 $0.00 $1,425.00 $100.14 TransDate EffDate TransactionDescription Amount Balance Beginning Balance......................................................................... 300.11",0.02,150.42
07/08,Deposit Home Banking Transfer From Share 10......................  REF# 61253231,300.00,600.11
07/14,Deposit Home Banking Transfer From Share 10......................  REF# 61413719,300.00,900.11
07/22,Deposit Home Banking Transfer From Share 10......................  REF# 61659217,300.00,"1,200.11"
07/25,Withdrawal Home Banking Transfer To Share 10....................  REF# 61745319,-25.00,"1,175.11"
07/25,"Deposit Home Banking Transfer REF# 61745338....................  From HODGES,JUSTINE B 532694 Share 10",25.00,"1,200.11"
07/28,Deposit Home Banking Transfer From Share 10......................  REF# 61834567,300.00,"1,500.11"
07/30,Withdrawal Home Banking Transfer To Share 10....................  REF# 61883097,-200.00,"1,300.11"
07/31,Withdrawal Home Banking......................................................  ACH WITHDRAWAL US BANK NA - JUSTINE HODGES,"-1,200.00",100.11
07/31,Deposit Dividend Tiered Rate..................................................  Annual Percentage Yield Earned 0.040% for period: 07/01/23 to 07/31/23 Ending Balance............................................................................. 100.14 No Strings Checking - 12 NO STRINGS CHECKING Dividends Earned YTD: 0.01 JointOwner:TYMITCHELL Beginning Balance + Deposits & Other Credits (0) - Checks Cleared (0) - Withdrawals & Other Debits (0) = Ending Balance $0.00 $0.00 $0.00 $0.00 $0.00 TransDate EffDate TransactionDescription Amount Balance Beginning Balance......................................................................... 0.00 Ending Balance............................................................................. 0.00 Equal Housing Opportunity Ent is a registered trademark of Ent Credit Union Insured by NCUA AccountNumber 1159412 StatementPeriod07/01/23thru07/31/23 Page 11 of 11 1111111111111111111111010001001100110111001110011000100010010001010000001110100011000011101011000110000001101100001100010011000000111000100110000000101111000100110010100111010111001010000100101001010100010011111001111111101011000111000000011100110011011001000101111010110011010110010111000010110011100000111111011000011111001011110001101101101010100111111001010000100100010101100010010101010011011010110110110000010111011010010001000100010111110010111001101011110101010101010101010101 No Strings Checking - 13 NO STRINGS CHECKING Dividends Earned YTD: 0.01 JointOwner:TYMITCHELL Beginning Balance + Deposits & Other Credits (2) - Checks Cleared (0) - Withdrawals & Other Debits (5) = Ending Balance $140.00 $180.00 $0.00 $320.00 $0.00 TransDate EffDate TransactionDescription Amount Balance Beginning Balance......................................................................... 140.00,0.03,100.14
07/11,Withdrawal Home Banking Transfer To Share 10....................  REF# 61344996,-70.00,70.00
07/13,Withdrawal Home Banking Transfer To Share 10....................  REF# 61398823,-40.00,30.00
07/14,Deposit Home Banking Transfer From Share 10......................  REF# 61413800,140.00,170.00
07/17,Withdrawal Home Banking Transfer To Share 10....................  REF# 61523416,-70.00,100.00
07/22,Deposit Home Banking Transfer From Share 10......................  REF# 61659225,40.00,140.00
07/22,Withdrawal Home Banking Transfer To Share 10....................  REF# 61666955,-70.00,70.00
07/23,"Withdrawal Home Banking Transfer To Share 10....................  REF# 61678441 Ending Balance............................................................................. 0.00 YEAR-TO-DATE DIVIDEND SUMMARY Reportable Dividends this Year:............................................................................. 0.46 Reportable dividends of $10.00 or more are reported to the IRS as interest income for the year. ** The Visa Foreign Currency Transaction Fee will be assessed to purchases made outside of the United States as well as to online purchases made within the United States, but the merchant is located outside the United States. ** No-cost loan payment alternatives are available, please call 800-525-9623 for more information. Equal Housing Opportunity Ent is a registered trademark of Ent Credit Union Insured by NCUA 391340-1.38-26008N11.no7 028700194 6-6",-70.00,0.00
